"iso 3","country id","country","trade value export","trade value import","trade value delta","year"
"ken","afken","Kenya",637,640,-3,1995
"zaf","afzaf","South Africa",7946,1879287,-1871341,1995
"chn","aschn","China",163410938,1453249,161957689,1995
"cyp","ascyp","Cyprus",1845,12019,-10174,1995
"hkg","ashkg","Hong Kong",3421010,6416825,-2995815,1995
"ind","asind","India",2038390,311912,1726478,1995
"jpn","asjpn","Japan",33957354,129747142,-95789788,1995
"kor","askor","South Korea",39333,19327339,-19288006,1995
"mys","asmys","Malaysia",38400,8786872,-8748472,1995
"prk","asprk","North Korea",658120,113500,544620,1995
"sau","assau","Saudi Arabia",15361,2728886,-2713525,1995
"sgp","assgp","Singapore",854591,6628355,-5773764,1995
"tha","astha","Thailand",19037,1383866,-1364829,1995
"twn","astwn","Chinese Taipei",4351901,10622836,-6270935,1995
"aut","euaut","Austria",10022540,4819461,5203079,1995
"bgr","eubgr","Bulgaria",52519,20614,31905,1995
"blx","eublx","Belgium-Luxembourg",2359340,5815150,-3455810,1995
"che","euche","Switzerland",546579,1686379,-1139800,1995
"cze","eucze","Czechia",34938,2132193,-2097255,1995
"deu","eudeu","Germany",4329752,38552587,-34222835,1995
"dnk","eudnk","Denmark",32715,116549,-83834,1995
"esp","euesp","Spain",212231,2991579,-2779348,1995
"est","euest","Estonia",16555939,5537213,11018726,1995
"fin","eufin","Finland",15526,684231,-668705,1995
"fra","eufra","France",116650582,31999217,84651365,1995
"gbr","eugbr","United Kingdom",16305176,16108831,196345,1995
"grc","eugrc","Greece",45443,204227,-158784,1995
"hun","euhun","Hungary",282080,2204831,-1922751,1995
"irl","euirl","Ireland",137144,392128,-254984,1995
"ita","euita","Italy",1946168,6097928,-4151760,1995
"ltu","eultu","Lithuania",29699,326457,-296758,1995
"nld","eunld","Netherlands",1709304,21357626,-19648322,1995
"nor","eunor","Norway",809232,277123,532109,1995
"pol","eupol","Poland",6927,744031,-737104,1995
"prt","euprt","Portugal",1575,350496,-348921,1995
"rus","eurus","Russia",11052324,1085892,9966432,1995
"svn","eusvn","Slovenia",62796,118639,-55843,1995
"swe","euswe","Sweden",74671,1550501,-1475830,1995
"ukr","euukr","Ukraine",132000,3601,128399,1995
"can","nacan","Canada",1028090,6785779,-5757689,1995
"usa","nausa","United States",56647275,100164272,-43516997,1995
"aus","ocaus","Australia",238841,912807,-673966,1995
"bra","sabra","Brazil",12263,3631547,-3619284,1995
"egy","afegy","Egypt",353972,1365209,-1011237,1996
"zaf","afzaf","South Africa",51655,2924826,-2873171,1996
"are","asare","United Arab Emirates",3832,15624,-11792,1996
"chn","aschn","China",213809718,2266145,211543573,1996
"cyp","ascyp","Cyprus",3171,9093,-5922,1996
"hkg","ashkg","Hong Kong",2852254,5075703,-2223449,1996
"ind","asind","India",3232657,1137840,2094817,1996
"jpn","asjpn","Japan",34779815,126412963,-91633148,1996
"kaz","askaz","Kazakhstan",1544268,921027,623241,1996
"kgz","askgz","Kyrgyzstan",1063690,44740,1018950,1996
"kor","askor","South Korea",40880,26681046,-26640166,1996
"mys","asmys","Malaysia",129145,6392429,-6263284,1996
"prk","asprk","North Korea",111684,78500,33184,1996
"sau","assau","Saudi Arabia",22689,532442,-509753,1996
"sgp","assgp","Singapore",1181375,4903434,-3722059,1996
"tha","astha","Thailand",10861,1744092,-1733231,1996
"tur","astur","Turkey",19006,1173127,-1154121,1996
"twn","astwn","Chinese Taipei",5937702,11934009,-5996307,1996
"aut","euaut","Austria",8953940,5271881,3682059,1996
"blr","eublr","Belarus",100600,31304,69296,1996
"blx","eublx","Belgium-Luxembourg",1817518,5130575,-3313057,1996
"che","euche","Switzerland",410923,1478329,-1067406,1996
"cze","eucze","Czechia",27783,1928923,-1901140,1996
"deu","eudeu","Germany",4800272,45640694,-40840422,1996
"dnk","eudnk","Denmark",21580,79020,-57440,1996
"esp","euesp","Spain",355316,3162288,-2806972,1996
"est","euest","Estonia",13326036,6987872,6338164,1996
"fin","eufin","Finland",956039,861535,94503.9999999999,1996
"fra","eufra","France",80025672,43779259,36246413,1996
"gbr","eugbr","United Kingdom",20258703,13813843,6444860,1996
"hrv","euhrv","Croatia",792,47946,-47154,1996
"hun","euhun","Hungary",20346,3426201,-3405855,1996
"irl","euirl","Ireland",2054004,601223,1452781,1996
"ita","euita","Italy",649152,5189436,-4540284,1996
"ltu","eultu","Lithuania",133602,460003,-326401,1996
"nld","eunld","Netherlands",521884,18459969,-17938085,1996
"nor","eunor","Norway",6404105,506039,5898066,1996
"pol","eupol","Poland",91425,812822,-721397,1996
"prt","euprt","Portugal",6695,425662,-418967,1996
"rus","eurus","Russia",11093474,1002017,10091457,1996
"swe","euswe","Sweden",71899,481977,-410078,1996
"ukr","euukr","Ukraine",486972,79989,406983,1996
"can","nacan","Canada",1139727,7042161,-5902434,1996
"mex","namex","Mexico",1431,979703,-978272,1996
"usa","nausa","United States",58710245,106308677,-47598432,1996
"aus","ocaus","Australia",26382,1542787,-1516405,1996
"arg","saarg","Argentina",2879,295206,-292327,1996
"bra","sabra","Brazil",87966,4430836,-4342870,1996
"civ","afciv","Cote d'Ivoire",4661,5937,-1276,1997
"mar","afmar","Morocco",92789,347985,-255196,1997
"zaf","afzaf","South Africa",51837,4569447,-4517610,1997
"are","asare","United Arab Emirates",2676,7924,-5248,1997
"chn","aschn","China",209178021,2353847,206824174,1997
"hkg","ashkg","Hong Kong",5635660,6781502,-1145842,1997
"idn","asidn","Indonesia",65316,525939,-460623,1997
"ind","asind","India",2291897,1773791,518106,1997
"isr","asisr","Israel",8000,157289,-149289,1997
"jpn","asjpn","Japan",33806468,121543306,-87736838,1997
"kaz","askaz","Kazakhstan",1643666,1766343,-122677,1997
"kgz","askgz","Kyrgyzstan",1533305,107121,1426184,1997
"kor","askor","South Korea",240604,27889763,-27649159,1997
"mys","asmys","Malaysia",48150,6680346,-6632196,1997
"sgp","assgp","Singapore",1317239,7763225,-6445986,1997
"tha","astha","Thailand",36868,1564760,-1527892,1997
"tur","astur","Turkey",9505,1385251,-1375746,1997
"twn","astwn","Chinese Taipei",4472740,11091966,-6619226,1997
"aut","euaut","Austria",11116137,5900807,5215330,1997
"blr","eublr","Belarus",80100,36459,43641,1997
"blx","eublx","Belgium-Luxembourg",1976551,6541408,-4564857,1997
"che","euche","Switzerland",317640,2156103,-1838463,1997
"cze","eucze","Czechia",20545,2000496,-1979951,1997
"deu","eudeu","Germany",3306909,44810143,-41503234,1997
"dnk","eudnk","Denmark",29725,98794,-69069,1997
"esp","euesp","Spain",912358,3505330,-2592972,1997
"est","euest","Estonia",5099156,5642453,-543297,1997
"fin","eufin","Finland",5128,569609,-564481,1997
"fra","eufra","France",85955411,24536254,61419157,1997
"gbr","eugbr","United Kingdom",14007278,20378974,-6371696,1997
"hun","euhun","Hungary",65342,3498438,-3433096,1997
"irl","euirl","Ireland",98328,238266,-139938,1997
"ita","euita","Italy",447969,7245110,-6797141,1997
"ltu","eultu","Lithuania",63800,367803,-304003,1997
"nld","eunld","Netherlands",807948,18805100,-17997152,1997
"nor","eunor","Norway",12990430,326693,12663737,1997
"pol","eupol","Poland",50687,546174,-495487,1997
"prt","euprt","Portugal",1616,350089,-348473,1997
"rus","eurus","Russia",6260455,1915930,4344525,1997
"svk","eusvk","Slovakia",7502,225831,-218329,1997
"swe","euswe","Sweden",12299,331200,-318901,1997
"ukr","euukr","Ukraine",158810,161782,-2972,1997
"can","nacan","Canada",2667342,8024117,-5356775,1997
"gtm","nagtm","Guatemala",24795,13656,11139,1997
"jam","najam","Jamaica",844,54162,-53318,1997
"mex","namex","Mexico",22667,1245040,-1222373,1997
"usa","nausa","United States",55901005,97105976,-41204971,1997
"aus","ocaus","Australia",218632,1245220,-1026588,1997
"arg","saarg","Argentina",12480,326943,-314463,1997
"bra","sabra","Brazil",2447,4375958,-4373511,1997
"zaf","afzaf","South Africa",83633,9526511,-9442878,1998
"are","asare","United Arab Emirates",16006,8551,7455,1998
"chn","aschn","China",227562533,4538802,223023731,1998
"hkg","ashkg","Hong Kong",7861370,7620634,240736,1998
"idn","asidn","Indonesia",1169,977707,-976538,1998
"ind","asind","India",879055,1382056,-503001,1998
"isr","asisr","Israel",24800,66681,-41881,1998
"jpn","asjpn","Japan",28909551,112977685,-84068134,1998
"kaz","askaz","Kazakhstan",936871,1032546,-95675,1998
"kgz","askgz","Kyrgyzstan",703827,60617,643210,1998
"kor","askor","South Korea",870405,22910977,-22040572,1998
"mys","asmys","Malaysia",269963,5140138,-4870175,1998
"phl","asphl","Philippines",68360,873580,-805220,1998
"prk","asprk","North Korea",15595,51894,-36299,1998
"sau","assau","Saudi Arabia",9072,30477,-21405,1998
"sgp","assgp","Singapore",1470016,6368278,-4898262,1998
"tha","astha","Thailand",185600,2065180,-1879580,1998
"tur","astur","Turkey",15507,1013173,-997666,1998
"twn","astwn","Chinese Taipei",3006964,12868588,-9861624,1998
"aut","euaut","Austria",11608158,6273517,5334641,1998
"blr","eublr","Belarus",5277,122447,-117170,1998
"blx","eublx","Belgium-Luxembourg",2991953,9042842,-6050889,1998
"che","euche","Switzerland",286372,3092186,-2805814,1998
"cze","eucze","Czechia",57319,1251280,-1193961,1998
"deu","eudeu","Germany",4573868,45032505,-40458637,1998
"dnk","eudnk","Denmark",29022,71561,-42539,1998
"esp","euesp","Spain",227077,3336401,-3109324,1998
"est","euest","Estonia",4946600,4220941,725659,1998
"fra","eufra","France",85078456,35875110,49203346,1998
"gbr","eugbr","United Kingdom",14185120,23527019,-9341899,1998
"hun","euhun","Hungary",389801,4009771,-3619970,1998
"irl","euirl","Ireland",534483,508522,25961,1998
"ita","euita","Italy",428642,6539168,-6110526,1998
"ltu","eultu","Lithuania",30622,280917,-250295,1998
"lva","eulva","Latvia",22568,4301,18267,1998
"nld","eunld","Netherlands",960415,19612343,-18651928,1998
"nor","eunor","Norway",18506545,902352,17604193,1998
"pol","eupol","Poland",30876,861422,-830546,1998
"rus","eurus","Russia",5737891,1271953,4465938,1998
"svk","eusvk","Slovakia",31699,333233,-301534,1998
"svn","eusvn","Slovenia",1137,76633,-75496,1998
"swe","euswe","Sweden",8422,469205,-460783,1998
"ukr","euukr","Ukraine",19163,59014,-39851,1998
"yug","euyug","Yugoslavia",8263,20741,-12478,1998
"can","nacan","Canada",1120922,6771817,-5650895,1998
"gtm","nagtm","Guatemala",41108,19192,21916,1998
"mex","namex","Mexico",91781,2193097,-2101316,1998
"usa","nausa","United States",51984978,102009169,-50024191,1998
"aus","ocaus","Australia",230267,1243710,-1013443,1998
"nzl","ocnzl","New Zealand",643,157591,-156948,1998
"arg","saarg","Argentina",1699,1126253,-1124554,1998
"chl","sachl","Chile",75707,69151,6556,1998
"per","saper","Peru",645,31229,-30584,1998
"ven","saven","Venezuela",2989,53270,-50281,1998
"zaf","afzaf","South Africa",159964,10132729,-9972765,1999
"are","asare","United Arab Emirates",73328,101644,-28316,1999
"chn","aschn","China",187207744,6428729,180779015,1999
"cyp","ascyp","Cyprus",2479,1082,1397,1999
"hkg","ashkg","Hong Kong",9171952,9676956,-505004,1999
"ind","asind","India",653283,2122359,-1469076,1999
"isr","asisr","Israel",19000,181944,-162944,1999
"jpn","asjpn","Japan",45150409,92495007,-47344598,1999
"kaz","askaz","Kazakhstan",72520,126000,-53480,1999
"kgz","askgz","Kyrgyzstan",827350,173998,653352,1999
"kor","askor","South Korea",664898,27412366,-26747468,1999
"mys","asmys","Malaysia",638425,5362199,-4723774,1999
"phl","asphl","Philippines",36399,460796,-424397,1999
"prk","asprk","North Korea",2865,13943,-11078,1999
"sgp","assgp","Singapore",3438054,8894250,-5456196,1999
"tha","astha","Thailand",111161,5322878,-5211717,1999
"tur","astur","Turkey",9988,610908,-600920,1999
"twn","astwn","Chinese Taipei",2037960,15683518,-13645558,1999
"aut","euaut","Austria",16179601,5472643,10706958,1999
"bel","eubel","Belgium",3255245,10454864,-7199619,1999
"che","euche","Switzerland",261820,1882664,-1620844,1999
"cze","eucze","Czechia",85419,1411561,-1326142,1999
"deu","eudeu","Germany",4014691,30144487,-26129796,1999
"dnk","eudnk","Denmark",56600,128173,-71573,1999
"esp","euesp","Spain",522816,4409598,-3886782,1999
"est","euest","Estonia",5349828,5500366,-150538,1999
"fin","eufin","Finland",8697,2537027,-2528330,1999
"fra","eufra","France",74379110,25220366,49158744,1999
"gbr","eugbr","United Kingdom",17217605,20116989,-2899384,1999
"hun","euhun","Hungary",1000,2233823,-2232823,1999
"irl","euirl","Ireland",3675453,1235445,2440008,1999
"ita","euita","Italy",714996,10935956,-10220960,1999
"ltu","eultu","Lithuania",1468,260362,-258894,1999
"nld","eunld","Netherlands",1380041,13273387,-11893346,1999
"nor","eunor","Norway",14806856,418332,14388524,1999
"prt","euprt","Portugal",985,276637,-275652,1999
"rus","eurus","Russia",14252263,791027,13461236,1999
"svk","eusvk","Slovakia",50625,229760,-179135,1999
"swe","euswe","Sweden",23028,587165,-564137,1999
"ukr","euukr","Ukraine",12636,8556,4080,1999
"brb","nabrb","Barbados",77568,6048,71520,1999
"can","nacan","Canada",240083,5272401,-5032318,1999
"gtm","nagtm","Guatemala",12951,9824,3127,1999
"mex","namex","Mexico",54827,1241487,-1186660,1999
"slv","naslv","El Salvador",24085,33952,-9866.99999999999,1999
"usa","nausa","United States",39277057,102495385,-63218328,1999
"aus","ocaus","Australia",346820,306628,40192,1999
"nzl","ocnzl","New Zealand",15341,143626,-128285,1999
"arg","saarg","Argentina",226022,1134373,-908351,1999
"bra","sabra","Brazil",677,4579459,-4578782,1999
"chl","sachl","Chile",57016,53431,3585.00000000001,1999
"col","sacol","Colombia",678,142613,-141935,1999
"ecu","saecu","Ecuador",2679,2049,630,1999
"civ","afciv","Cote d'Ivoire",82,476,-394,2000
"ken","afken","Kenya",629,14627,-13998,2000
"swz","afswz","Eswatini",326,885,-559,2000
"tun","aftun","Tunisia",77110,66944,10166,2000
"zaf","afzaf","South Africa",435658,8298757,-7863099,2000
"are","asare","United Arab Emirates",253283,17234,236049,2000
"chn","aschn","China",210167488,3988114,206179374,2000
"cyp","ascyp","Cyprus",53897,4362,49535,2000
"hkg","ashkg","Hong Kong",2128913,3074133,-945220,2000
"idn","asidn","Indonesia",32027,914103,-882076,2000
"ind","asind","India",2731260,913713,1817547,2000
"isr","asisr","Israel",75,210102,-210027,2000
"jpn","asjpn","Japan",49209778,118797152,-69587374,2000
"kaz","askaz","Kazakhstan",396578,189089,207489,2000
"kor","askor","South Korea",802326,33449884,-32647558,2000
"lbn","aslbn","Lebanon",9947,9817,130.000000000002,2000
"mys","asmys","Malaysia",321087,6310960,-5989873,2000
"sau","assau","Saudi Arabia",38892,219181,-180289,2000
"sgp","assgp","Singapore",16435392,15020985,1414407,2000
"tha","astha","Thailand",29618,18979564,-18949946,2000
"tur","astur","Turkey",23397,732613,-709216,2000
"twn","astwn","Chinese Taipei",3412160,18637972,-15225812,2000
"aut","euaut","Austria",16971917,11493633,5478284,2000
"bel","eubel","Belgium",4357270,8680859,-4323589,2000
"blr","eublr","Belarus",7800,280909,-273109,2000
"che","euche","Switzerland",329518,1408878,-1079360,2000
"cze","eucze","Czechia",113359,1317028,-1203669,2000
"deu","eudeu","Germany",5015487,27080808,-22065321,2000
"dnk","eudnk","Denmark",30812,81245,-50433,2000
"esp","euesp","Spain",675237,2620949,-1945712,2000
"est","euest","Estonia",6636088,1028749,5607339,2000
"fin","eufin","Finland",35,2997369,-2997334,2000
"fra","eufra","France",68132848,26241197,41891651,2000
"gbr","eugbr","United Kingdom",17040193,15320083,1720110,2000
"grc","eugrc","Greece",6000,99158,-93158,2000
"hun","euhun","Hungary",10132,2494084,-2483952,2000
"irl","euirl","Ireland",965576,1027195,-61619,2000
"ita","euita","Italy",444217,9432482,-8988265,2000
"lva","eulva","Latvia",2942,22958990,-22956048,2000
"nld","eunld","Netherlands",833644,21054427,-20220783,2000
"nor","eunor","Norway",24241017,283396,23957621,2000
"rus","eurus","Russia",25496997,1564123,23932874,2000
"svn","eusvn","Slovenia",391,70962,-70571,2000
"swe","euswe","Sweden",35897,475040,-439143,2000
"ukr","euukr","Ukraine",12652,47761,-35109,2000
"bhs","nabhs","Bahamas",54,8808,-8754,2000
"can","nacan","Canada",561357,6347160,-5785803,2000
"gtm","nagtm","Guatemala",71,10771,-10700,2000
"mex","namex","Mexico",87572,1768039,-1680467,2000
"tto","natto","Trinidad and Tobago",152,9761,-9609,2000
"usa","nausa","United States",46165721,97876427,-51710706,2000
"vgb","navgb","British Virgin Islands",2328,15439,-13111,2000
"aus","ocaus","Australia",216352,364643,-148291,2000
"nzl","ocnzl","New Zealand",9416,90383,-80967,2000
"arg","saarg","Argentina",412153,1155125,-742972,2000
"bra","sabra","Brazil",573,6471229,-6470656,2000
"col","sacol","Colombia",615,98829,-98214,2000
"guy","saguy","Guyana",34000,5748,28252,2000
"eth","afeth","Ethiopia",1000,5986,-4986,2001
"ken","afken","Kenya",85,608,-523,2001
"mar","afmar","Morocco",11655,249719,-238064,2001
"mrt","afmrt","Mauritania",59,683,-624,2001
"nga","afnga","Nigeria",497,101080,-100583,2001
"sen","afsen","Senegal",72,21828,-21756,2001
"zaf","afzaf","South Africa",195368,4690309,-4494941,2001
"zwe","afzwe","Zimbabwe",140,16397,-16257,2001
"chn","aschn","China",241619363,3940420,237678943,2001
"cyp","ascyp","Cyprus",48511,36087,12424,2001
"hkg","ashkg","Hong Kong",1545195,4703222,-3158027,2001
"idn","asidn","Indonesia",9731,751835,-742104,2001
"ind","asind","India",3898674,1843990,2054684,2001
"isr","asisr","Israel",24420,173184,-148764,2001
"jor","asjor","Jordan",15362,11072,4290,2001
"jpn","asjpn","Japan",39186132,98731410,-59545278,2001
"kaz","askaz","Kazakhstan",1991703,938271,1053432,2001
"kgz","askgz","Kyrgyzstan",490976,40,490936,2001
"kor","askor","South Korea",1425079,32762222,-31337143,2001
"lbn","aslbn","Lebanon",13263,17168,-3905,2001
"lka","aslka","Sri Lanka",63,62828,-62765,2001
"mys","asmys","Malaysia",180135,4680229,-4500094,2001
"sau","assau","Saudi Arabia",1514671,169240,1345431,2001
"sgp","assgp","Singapore",15303796,12070339,3233457,2001
"tha","astha","Thailand",10848,16615304,-16604456,2001
"tur","astur","Turkey",2753,687333,-684580,2001
"twn","astwn","Chinese Taipei",1928243,16193450,-14265207,2001
"aut","euaut","Austria",24140453,12135421,12005032,2001
"bel","eubel","Belgium",6672213,8490286,-1818073,2001
"blr","eublr","Belarus",95286,309239,-213953,2001
"che","euche","Switzerland",476701,1396351,-919650,2001
"cze","eucze","Czechia",125989,1484501,-1358512,2001
"deu","eudeu","Germany",5697073,27755736,-22058663,2001
"dnk","eudnk","Denmark",32407,191708,-159301,2001
"esp","euesp","Spain",421543,4152250,-3730707,2001
"est","euest","Estonia",5130164,3798053,1332111,2001
"fin","eufin","Finland",28904,2219540,-2190636,2001
"fra","eufra","France",57436572,54955028,2481544,2001
"gbr","eugbr","United Kingdom",16492527,17304365,-811838,2001
"grc","eugrc","Greece",303,119997,-119694,2001
"hrv","euhrv","Croatia",14,17107,-17093,2001
"hun","euhun","Hungary",131878,2939916,-2808038,2001
"irl","euirl","Ireland",1520362,789895,730467,2001
"ita","euita","Italy",794168,8757339,-7963171,2001
"ltu","eultu","Lithuania",18225,402271,-384046,2001
"nld","eunld","Netherlands",573860,18449619,-17875759,2001
"nor","eunor","Norway",25235368,82947,25152421,2001
"pol","eupol","Poland",10294,380062,-369768,2001
"prt","euprt","Portugal",671,176317,-175646,2001
"rou","eurou","Romania",13436,74520,-61084,2001
"rus","eurus","Russia",8702777,1290357,7412420,2001
"svk","eusvk","Slovakia",1228,275620,-274392,2001
"swe","euswe","Sweden",50442,826381,-775939,2001
"ukr","euukr","Ukraine",37809,51351,-13542,2001
"can","nacan","Canada",305547,7558040,-7252493,2001
"cri","nacri","Costa Rica",3583,7135,-3552,2001
"mex","namex","Mexico",51322,3051881,-3000559,2001
"usa","nausa","United States",33346460,106164724,-72818264,2001
"aus","ocaus","Australia",112975,426939,-313964,2001
"nzl","ocnzl","New Zealand",15177,50059,-34882,2001
"arg","saarg","Argentina",421498,464513,-43015,2001
"bra","sabra","Brazil",42510,7948087,-7905577,2001
"col","sacol","Colombia",229,166147,-165918,2001
"ken","afken","Kenya",3447,3351,96,2002
"nga","afnga","Nigeria",10059,989618,-979559,2002
"uga","afuga","Uganda",75000,22297,52703,2002
"zaf","afzaf","South Africa",193490,6024947,-5831457,2002
"zmb","afzmb","Zambia",44,7821,-7777,2002
"are","asare","United Arab Emirates",11028,64639,-53611,2002
"chn","aschn","China",178448010,5555939,172892071,2002
"cyp","ascyp","Cyprus",13164,6234,6930,2002
"hkg","ashkg","Hong Kong",785696,4132604,-3346908,2002
"idn","asidn","Indonesia",23853,1031403,-1007550,2002
"ind","asind","India",2739988,1936245,803743,2002
"isr","asisr","Israel",807025,336342,470683,2002
"jpn","asjpn","Japan",47960607,87364736,-39404129,2002
"kaz","askaz","Kazakhstan",825670,657310,168360,2002
"kor","askor","South Korea",2261612,37418313,-35156701,2002
"lbn","aslbn","Lebanon",26658,7373,19285,2002
"lka","aslka","Sri Lanka",63,14949,-14886,2002
"mys","asmys","Malaysia",160210,5072832,-4912622,2002
"phl","asphl","Philippines",23859,173444,-149585,2002
"sau","assau","Saudi Arabia",165681,137528,28153,2002
"sgp","assgp","Singapore",15427451,12770793,2656658,2002
"tha","astha","Thailand",66814,17925541,-17858727,2002
"tur","astur","Turkey",3336,929566,-926230,2002
"twn","astwn","Chinese Taipei",1410278,18554172,-17143894,2002
"aut","euaut","Austria",23599543,10385412,13214131,2002
"bel","eubel","Belgium",4246008,4568768,-322760,2002
"bgr","eubgr","Bulgaria",2777,21803,-19026,2002
"che","euche","Switzerland",886287,846236,40051.0000000001,2002
"cze","eucze","Czechia",48197,2640906,-2592709,2002
"deu","eudeu","Germany",5341922,28554589,-23212667,2002
"dnk","eudnk","Denmark",23361,160348,-136987,2002
"esp","euesp","Spain",299092,3541196,-3242104,2002
"est","euest","Estonia",7682908,611282,7071626,2002
"fin","eufin","Finland",21615,2847208,-2825593,2002
"fra","eufra","France",53794995,21266746,32528249,2002
"gbr","eugbr","United Kingdom",19304922,18560325,744597,2002
"hun","euhun","Hungary",903,3954375,-3953472,2002
"irl","euirl","Ireland",1267051,980512,286539,2002
"ita","euita","Italy",937343,7270303,-6332960,2002
"ltu","eultu","Lithuania",71914,514040,-442126,2002
"nld","eunld","Netherlands",680526,12975284,-12294758,2002
"nor","eunor","Norway",10307537,131732,10175805,2002
"pol","eupol","Poland",16480,423351,-406871,2002
"prt","euprt","Portugal",560,188722,-188162,2002
"rus","eurus","Russia",12430287,1941165,10489122,2002
"svk","eusvk","Slovakia",1173,173335,-172162,2002
"svn","eusvn","Slovenia",494,83591,-83097,2002
"swe","euswe","Sweden",16311,1168423,-1152112,2002
"ukr","euukr","Ukraine",98968,51858,47110,2002
"brb","nabrb","Barbados",498,174,324,2002
"can","nacan","Canada",189939,11398293,-11208354,2002
"cub","nacub","Cuba",5265,27601,-22336,2002
"mex","namex","Mexico",33614,3365416,-3331802,2002
"nic","nanic","Nicaragua",1558,146017,-144459,2002
"usa","nausa","United States",36498912,81691741,-45192829,2002
"aus","ocaus","Australia",249019,280495,-31476,2002
"nzl","ocnzl","New Zealand",311,13829,-13518,2002
"arg","saarg","Argentina",311419,269571,41848,2002
"bra","sabra","Brazil",61947,5415425,-5353478,2002
"chl","sachl","Chile",5996,290681,-284685,2002
"civ","afciv","Cote d'Ivoire",115385,3664,111721,2003
"ken","afken","Kenya",29122,6790,22332,2003
"sen","afsen","Senegal",1388,11276,-9888,2003
"zaf","afzaf","South Africa",846883,4309123,-3462240,2003
"are","asare","United Arab Emirates",51132,62258,-11126,2003
"chn","aschn","China",189206503,9296237,179910266,2003
"hkg","ashkg","Hong Kong",1233056,4789925,-3556869,2003
"idn","asidn","Indonesia",36109,4325413,-4289304,2003
"ind","asind","India",765138,1544678,-779540,2003
"isr","asisr","Israel",993026,623041,369985,2003
"jpn","asjpn","Japan",60487935,99765225,-39277290,2003
"kaz","askaz","Kazakhstan",858705,332657,526048,2003
"kgz","askgz","Kyrgyzstan",237033,5844,231189,2003
"kor","askor","South Korea",3442517,38816287,-35373770,2003
"lka","aslka","Sri Lanka",5697,36853,-31156,2003
"mys","asmys","Malaysia",46712,4563006,-4516294,2003
"sau","assau","Saudi Arabia",231121,300813,-69692,2003
"sgp","assgp","Singapore",13142453,10304406,2838047,2003
"tha","astha","Thailand",11031,13086638,-13075607,2003
"tjk","astjk","Tajikistan",1000,58,942,2003
"tur","astur","Turkey",8550,1165872,-1157322,2003
"twn","astwn","Chinese Taipei",2155371,22703655,-20548284,2003
"aut","euaut","Austria",23874253,5988032,17886221,2003
"bel","eubel","Belgium",3011846,5954314,-2942468,2003
"bgr","eubgr","Bulgaria",993,67754,-66761,2003
"che","euche","Switzerland",752360,1310636,-558276,2003
"cze","eucze","Czechia",48146,3033875,-2985729,2003
"deu","eudeu","Germany",6382364,32937893,-26555529,2003
"dnk","eudnk","Denmark",19382,153615,-134233,2003
"esp","euesp","Spain",190582,4026404,-3835822,2003
"est","euest","Estonia",4784657,723087,4061570,2003
"fin","eufin","Finland",5176,636667,-631491,2003
"fra","eufra","France",67555692,27716306,39839386,2003
"gbr","eugbr","United Kingdom",21965494,24677997,-2712503,2003
"hrv","euhrv","Croatia",97,7990,-7893,2003
"irl","euirl","Ireland",1675340,3969535,-2294195,2003
"ita","euita","Italy",3788965,9594395,-5805430,2003
"ltu","eultu","Lithuania",3510,357093,-353583,2003
"nld","eunld","Netherlands",2037237,20273635,-18236398,2003
"nor","eunor","Norway",10630262,190164,10440098,2003
"pol","eupol","Poland",23996,541920,-517924,2003
"prt","euprt","Portugal",1479,357637,-356158,2003
"rus","eurus","Russia",23273997,2174476,21099521,2003
"svk","eusvk","Slovakia",806,70419,-69613,2003
"svn","eusvn","Slovenia",636,94383,-93747,2003
"swe","euswe","Sweden",12183,1683939,-1671756,2003
"ukr","euukr","Ukraine",69652,91831,-22179,2003
"can","nacan","Canada",359447,14414305,-14054858,2003
"cri","nacri","Costa Rica",288,23558,-23270,2003
"mex","namex","Mexico",100734,6019232,-5918498,2003
"nic","nanic","Nicaragua",29484,431,29053,2003
"slv","naslv","El Salvador",5145,77,5068,2003
"usa","nausa","United States",35924986,85423369,-49498383,2003
"aus","ocaus","Australia",281380,310032,-28652,2003
"ncl","ocncl","New Caledonia",30840,3518,27322,2003
"nzl","ocnzl","New Zealand",1947,10775,-8828,2003
"arg","saarg","Argentina",365498,263942,101556,2003
"bra","sabra","Brazil",49517,3887087,-3837570,2003
"ven","saven","Venezuela",27648,35022,-7374,2003
"ken","afken","Kenya",17870,4078,13792,2004
"nam","afnam","Namibia",16,6522,-6506,2004
"tun","aftun","Tunisia",9,27054,-27045,2004
"zaf","afzaf","South Africa",570793,4035901,-3465108,2004
"zwe","afzwe","Zimbabwe",50130,13451,36679,2004
"are","asare","United Arab Emirates",83427,97916,-14489,2004
"bgd","asbgd","Bangladesh",7517,82218,-74701,2004
"brn","asbrn","Brunei",72,8804,-8732,2004
"chn","aschn","China",215346433,19915600,195430833,2004
"hkg","ashkg","Hong Kong",848330,4789269,-3940939,2004
"idn","asidn","Indonesia",68949,1113199,-1044250,2004
"ind","asind","India",814817,3693577,-2878760,2004
"isr","asisr","Israel",881655,1255277,-373622,2004
"jpn","asjpn","Japan",73763029,129115608,-55352579,2004
"kaz","askaz","Kazakhstan",1647250,272299,1374951,2004
"kor","askor","South Korea",7632477,42779766,-35147289,2004
"lbn","aslbn","Lebanon",221,44223,-44002,2004
"mys","asmys","Malaysia",124222,5526855,-5402633,2004
"phl","asphl","Philippines",36051,2739403,-2703352,2004
"sau","assau","Saudi Arabia",82029,74673,7356,2004
"sgp","assgp","Singapore",1532783,3346960,-1814177,2004
"tha","astha","Thailand",334317,5720208,-5385891,2004
"tur","astur","Turkey",4981,1112580,-1107599,2004
"twn","astwn","Chinese Taipei",1742750,22087208,-20344458,2004
"aut","euaut","Austria",22514861,5538298,16976563,2004
"bel","eubel","Belgium",2912734,4119879,-1207145,2004
"bih","eubih","Bosnia and Herzegovina",249816,2631,247185,2004
"blr","eublr","Belarus",2000,310918,-308918,2004
"che","euche","Switzerland",644585,1532587,-888002,2004
"cze","eucze","Czechia",98640,2189590,-2090950,2004
"deu","eudeu","Germany",8882224,30132142,-21249918,2004
"dnk","eudnk","Denmark",62997,147619,-84622,2004
"esp","euesp","Spain",198616,5267536,-5068920,2004
"est","euest","Estonia",2338536,1964539,373997,2004
"fin","eufin","Finland",58969,431210,-372241,2004
"fra","eufra","France",72371771,31230699,41141072,2004
"gbr","eugbr","United Kingdom",15407384,29981789,-14574405,2004
"hun","euhun","Hungary",3962,3371361,-3367399,2004
"irl","euirl","Ireland",1445900,2980833,-1534933,2004
"ita","euita","Italy",3397398,9375262,-5977864,2004
"ltu","eultu","Lithuania",4549,374339,-369790,2004
"lva","eulva","Latvia",753,3921,-3168,2004
"nld","eunld","Netherlands",4947772,14987783,-10040011,2004
"nor","eunor","Norway",13804193,162394,13641799,2004
"pol","eupol","Poland",2647,1432894,-1430247,2004
"rus","eurus","Russia",16828532,1853061,14975471,2004
"svk","eusvk","Slovakia",689,159879,-159190,2004
"svn","eusvn","Slovenia",4877,121302,-116425,2004
"swe","euswe","Sweden",76698,1430477,-1353779,2004
"ukr","euukr","Ukraine",87088,88578,-1490,2004
"can","nacan","Canada",360896,11532125,-11171229,2004
"cri","nacri","Costa Rica",64,12096,-12032,2004
"gtm","nagtm","Guatemala",397,3876,-3479,2004
"jam","najam","Jamaica",27001,673333,-646332,2004
"mex","namex","Mexico",69654,3919611,-3849957,2004
"usa","nausa","United States",36057361,85714379,-49657018,2004
"aus","ocaus","Australia",104296,249289,-144993,2004
"nzl","ocnzl","New Zealand",990,26330,-25340,2004
"arg","saarg","Argentina",348012,443718,-95706,2004
"bra","sabra","Brazil",3608,3118629,-3115021,2004
"chl","sachl","Chile",475,191824,-191349,2004
"cmr","afcmr","Cameroon",3785,105,3680,2005
"egy","afegy","Egypt",42916,1770652,-1727736,2005
"gin","afgin","Guinea",1427,11141,-9714,2005
"mar","afmar","Morocco",268,217301,-217033,2005
"mus","afmus","Mauritius",421,11875,-11454,2005
"nam","afnam","Namibia",1709,3723,-2014,2005
"nga","afnga","Nigeria",9,1784,-1775,2005
"zaf","afzaf","South Africa",515383,4547656,-4032273,2005
"zwe","afzwe","Zimbabwe",32630,32030,600.000000000004,2005
"are","asare","United Arab Emirates",103206,319481,-216275,2005
"chn","aschn","China",219067555,32038926,187028629,2005
"hkg","ashkg","Hong Kong",1001858,6806255,-5804397,2005
"idn","asidn","Indonesia",56492,1002649,-946157,2005
"ind","asind","India",652545,5029654,-4377109,2005
"isr","asisr","Israel",15462,566103,-550641,2005
"jpn","asjpn","Japan",134237785,127972351,6265434,2005
"kaz","askaz","Kazakhstan",1217588,193594,1023994,2005
"kor","askor","South Korea",2441469,42685382,-40243913,2005
"lbn","aslbn","Lebanon",27847,43615,-15768,2005
"mys","asmys","Malaysia",1022641,3056478,-2033837,2005
"phl","asphl","Philippines",252600,3426516,-3173916,2005
"sau","assau","Saudi Arabia",255831,188149,67682,2005
"sgp","assgp","Singapore",829929,3285496,-2455567,2005
"tha","astha","Thailand",217189,46093974,-45876785,2005
"tur","astur","Turkey",1960,815309,-813349,2005
"twn","astwn","Chinese Taipei",1254267,22494403,-21240136,2005
"aut","euaut","Austria",24089716,5053731,19035985,2005
"bel","eubel","Belgium",2948912,2723008,225904,2005
"bih","eubih","Bosnia and Herzegovina",21925,1801,20124,2005
"che","euche","Switzerland",871353,1576684,-705331,2005
"cze","eucze","Czechia",146706,2860870,-2714164,2005
"deu","eudeu","Germany",10288463,32876239,-22587776,2005
"dnk","eudnk","Denmark",452924,122274,330650,2005
"esp","euesp","Spain",457706,6251859,-5794153,2005
"est","euest","Estonia",3870890,3069759,801131,2005
"fin","eufin","Finland",14158,600225,-586067,2005
"fra","eufra","France",62714765,25408044,37306721,2005
"gbr","eugbr","United Kingdom",18653797,18773573,-119776,2005
"hun","euhun","Hungary",7000,2555202,-2548202,2005
"irl","euirl","Ireland",445991,896260,-450269,2005
"ita","euita","Italy",5921461,12141291,-6219830,2005
"ltu","eultu","Lithuania",6723,108919,-102196,2005
"nld","eunld","Netherlands",7427705,22192385,-14764680,2005
"nor","eunor","Norway",9834379,103537,9730842,2005
"pol","eupol","Poland",2612,1441645,-1439033,2005
"prt","euprt","Portugal",393,347736,-347343,2005
"rus","eurus","Russia",8791137,2394955,6396182,2005
"svk","eusvk","Slovakia",9603,175843,-166240,2005
"svn","eusvn","Slovenia",46641,149049,-102408,2005
"swe","euswe","Sweden",181014,878651,-697637,2005
"ukr","euukr","Ukraine",312294,91774,220520,2005
"brb","nabrb","Barbados",25157,380,24777,2005
"can","nacan","Canada",270590,4674563,-4403973,2005
"cri","nacri","Costa Rica",10110,10291,-181,2005
"gtm","nagtm","Guatemala",125,4467,-4342,2005
"mex","namex","Mexico",28976,3608130,-3579154,2005
"tto","natto","Trinidad and Tobago",212,704,-492,2005
"usa","nausa","United States",29002368,88068320,-59065952,2005
"aus","ocaus","Australia",34782,272187,-237405,2005
"nzl","ocnzl","New Zealand",23069,22852,216.999999999996,2005
"arg","saarg","Argentina",427254,1202209,-774955,2005
"bra","sabra","Brazil",7194,3834331,-3827137,2005
"chl","sachl","Chile",8816,568139,-559323,2005
"col","sacol","Colombia",705,177274,-176569,2005
"sur","sasur","Suriname",375,50,325,2005
"egy","afegy","Egypt",18282,1508489,-1490207,2006
"ken","afken","Kenya",57,6098,-6041,2006
"uga","afuga","Uganda",612,27,585,2006
"zaf","afzaf","South Africa",379428,4064360,-3684932,2006
"are","asare","United Arab Emirates",8231,519791,-511560,2006
"arm","asarm","Armenia",24003,136,23867,2006
"brn","asbrn","Brunei",8,8980,-8972,2006
"chn","aschn","China",326656275,82399794,244256481,2006
"hkg","ashkg","Hong Kong",1552206,6223052,-4670846,2006
"idn","asidn","Indonesia",258,822922,-822664,2006
"ind","asind","India",1612938,5052417,-3439479,2006
"isr","asisr","Israel",51224,1818564,-1767340,2006
"jpn","asjpn","Japan",187542082,209480966,-21938884,2006
"kaz","askaz","Kazakhstan",6032156,366544,5665612,2006
"kor","askor","South Korea",1874890,47621410,-45746520,2006
"kwt","askwt","Kuwait",90,99063,-98973,2006
"lbn","aslbn","Lebanon",15219,34558,-19339,2006
"mys","asmys","Malaysia",112048,3526312,-3414264,2006
"pak","aspak","Pakistan",656,23526,-22870,2006
"phl","asphl","Philippines",267491,2943030,-2675539,2006
"sau","assau","Saudi Arabia",13461,661174,-647713,2006
"sgp","assgp","Singapore",1506946,1955930,-448984,2006
"tha","astha","Thailand",38178,48918096,-48879918,2006
"tur","astur","Turkey",42929,6098149,-6055220,2006
"twn","astwn","Chinese Taipei",2521928,25866987,-23345059,2006
"vnm","asvnm","Vietnam",6516,1193498,-1186982,2006
"aut","euaut","Austria",20006073,5643421,14362652,2006
"bel","eubel","Belgium",2930465,5075906,-2145441,2006
"bgr","eubgr","Bulgaria",103,8459,-8356,2006
"blr","eublr","Belarus",14200,322986,-308786,2006
"che","euche","Switzerland",943677,1936051,-992374,2006
"cze","eucze","Czechia",213572,3856008,-3642436,2006
"deu","eudeu","Germany",16857945,34309259,-17451314,2006
"dnk","eudnk","Denmark",28951,285124,-256173,2006
"esp","euesp","Spain",745045,7803425,-7058380,2006
"est","euest","Estonia",8161271,3702648,4458623,2006
"fin","eufin","Finland",123120,597606,-474486,2006
"fra","eufra","France",67553438,51872417,15681021,2006
"gbr","eugbr","United Kingdom",28746313,11556620,17189693,2006
"hun","euhun","Hungary",3000,2610624,-2607624,2006
"irl","euirl","Ireland",1392530,628693,763837,2006
"ita","euita","Italy",5682632,12131800,-6449168,2006
"ltu","eultu","Lithuania",53484,131814,-78330,2006
"lux","eulux","Luxembourg",930,52979,-52049,2006
"nld","eunld","Netherlands",6443711,33700121,-27256410,2006
"nor","eunor","Norway",11578359,216858,11361501,2006
"pol","eupol","Poland",89237,2175567,-2086330,2006
"prt","euprt","Portugal",190,690747,-690557,2006
"rus","eurus","Russia",6484153,2274357,4209796,2006
"svn","eusvn","Slovenia",1367,120422,-119055,2006
"swe","euswe","Sweden",207111,1159172,-952061,2006
"ukr","euukr","Ukraine",28473,69431,-40958,2006
"brb","nabrb","Barbados",11946,3056,8890,2006
"can","nacan","Canada",384827,3553181,-3168354,2006
"gtm","nagtm","Guatemala",406,31777,-31371,2006
"mex","namex","Mexico",3486,3960105,-3956619,2006
"pan","napan","Panama",7,83882,-83875,2006
"tto","natto","Trinidad and Tobago",4198,8168,-3970,2006
"usa","nausa","United States",38903708,93445958,-54542250,2006
"aus","ocaus","Australia",82841,577818,-494977,2006
"nzl","ocnzl","New Zealand",1101,43039,-41938,2006
"arg","saarg","Argentina",421414,1033411,-611997,2006
"bra","sabra","Brazil",351520,4166685,-3815165,2006
"col","sacol","Colombia",485,135867,-135382,2006
"dza","afdza","Algeria",11518,13960,-2442,2007
"ken","afken","Kenya",947,14292,-13345,2007
"mar","afmar","Morocco",1467,265728,-264261,2007
"mli","afmli","Mali",1114,16014,-14900,2007
"nam","afnam","Namibia",7029,456,6573,2007
"zaf","afzaf","South Africa",289671,2700581,-2410910,2007
"zwe","afzwe","Zimbabwe",1644,9599,-7955,2007
"are","asare","United Arab Emirates",31508,472630,-441122,2007
"arm","asarm","Armenia",2211,498,1713,2007
"brn","asbrn","Brunei",62,8180,-8118,2007
"chn","aschn","China",524708160,88699827,436008333,2007
"geo","asgeo","Georgia",203,4935,-4732,2007
"hkg","ashkg","Hong Kong",4502521,32585504,-28082983,2007
"idn","asidn","Indonesia",121,657015,-656894,2007
"ind","asind","India",1102159,3895007,-2792848,2007
"isr","asisr","Israel",72030,1701698,-1629668,2007
"jpn","asjpn","Japan",240471672,327547787,-87076115,2007
"kaz","askaz","Kazakhstan",3334388,1651249,1683139,2007
"kor","askor","South Korea",3519594,52563872,-49044278,2007
"lka","aslka","Sri Lanka",11354,43904,-32550,2007
"mys","asmys","Malaysia",213036,3133388,-2920352,2007
"qat","asqat","Qatar",22843,14716,8127,2007
"sau","assau","Saudi Arabia",85174,1319602,-1234428,2007
"sgp","assgp","Singapore",1431451,3201041,-1769590,2007
"tha","astha","Thailand",125885,99454882,-99328997,2007
"tur","astur","Turkey",23455,2739530,-2716075,2007
"twn","astwn","Chinese Taipei",3259647,23655449,-20395802,2007
"vnm","asvnm","Vietnam",271953,1265119,-993166,2007
"aut","euaut","Austria",30207564,8271297,21936267,2007
"bel","eubel","Belgium",6699676,7172096,-472420,2007
"bgr","eubgr","Bulgaria",226,28746,-28520,2007
"che","euche","Switzerland",958853,2165135,-1206282,2007
"cze","eucze","Czechia",328234,4049633,-3721399,2007
"deu","eudeu","Germany",15432179,41079369,-25647190,2007
"dnk","eudnk","Denmark",346988,324847,22141,2007
"esp","euesp","Spain",1390765,12270717,-10879952,2007
"est","euest","Estonia",11174452,1735922,9438530,2007
"fin","eufin","Finland",2497,566307,-563810,2007
"fra","eufra","France",81690806,57046872,24643934,2007
"gbr","eugbr","United Kingdom",13450236,18310612,-4860376,2007
"grc","eugrc","Greece",742,38658,-37916,2007
"hrv","euhrv","Croatia",11868,27675,-15807,2007
"hun","euhun","Hungary",3744,3374828,-3371084,2007
"irl","euirl","Ireland",149907,496913,-347006,2007
"isl","euisl","Iceland",128000,1394,126606,2007
"ita","euita","Italy",13960637,17573494,-3612857,2007
"ltu","eultu","Lithuania",13860,49774,-35914,2007
"lva","eulva","Latvia",126900,2067934,-1941034,2007
"nld","eunld","Netherlands",6375316,43190831,-36815515,2007
"nor","eunor","Norway",6971386,182114,6789272,2007
"pol","eupol","Poland",4330455,2967378,1363077,2007
"prt","euprt","Portugal",13036,324561,-311525,2007
"rus","eurus","Russia",7467402,4540927,2926475,2007
"svn","eusvn","Slovenia",7684,132646,-124962,2007
"swe","euswe","Sweden",177847,1586808,-1408961,2007
"ukr","euukr","Ukraine",131097,132069,-972,2007
"brb","nabrb","Barbados",69715,1383,68332,2007
"can","nacan","Canada",342979,2920895,-2577916,2007
"gtm","nagtm","Guatemala",2534,8256,-5722,2007
"mex","namex","Mexico",35120,4554831,-4519711,2007
"pan","napan","Panama",14195,9849,4346,2007
"slv","naslv","El Salvador",5941,5425,516,2007
"usa","nausa","United States",29067742,119832853,-90765111,2007
"aus","ocaus","Australia",365581,273147,92434,2007
"arg","saarg","Argentina",494604,1254168,-759564,2007
"bra","sabra","Brazil",1444525,5146260,-3701735,2007
"col","sacol","Colombia",5092,161572,-156480,2007
"egy","afegy","Egypt",13741,1053758,-1040017,2008
"ken","afken","Kenya",46,1907,-1861,2008
"nam","afnam","Namibia",2729,4568,-1839,2008
"swz","afswz","Eswatini",10462,8980,1482,2008
"tza","aftza","Tanzania",4685,35833,-31148,2008
"zaf","afzaf","South Africa",554760,2628043,-2073283,2008
"are","asare","United Arab Emirates",29154,1315645,-1286491,2008
"arm","asarm","Armenia",1554,24339,-22785,2008
"chn","aschn","China",566095697,25581921,540513776,2008
"hkg","ashkg","Hong Kong",7958069,12618700,-4660631,2008
"idn","asidn","Indonesia",4,1304283,-1304279,2008
"ind","asind","India",711479,4707259,-3995780,2008
"isr","asisr","Israel",4643,1962868,-1958225,2008
"jpn","asjpn","Japan",154040506,361593407,-207552901,2008
"kaz","askaz","Kazakhstan",3691310,2246540,1444770,2008
"kor","askor","South Korea",4283909,64389488,-60105579,2008
"lka","aslka","Sri Lanka",794573,43887,750686,2008
"mys","asmys","Malaysia",228032,6065973,-5837941,2008
"sau","assau","Saudi Arabia",43188,1275147,-1231959,2008
"sgp","assgp","Singapore",2433605,3890271,-1456666,2008
"tha","astha","Thailand",201837,41353065,-41151228,2008
"tur","astur","Turkey",94251,1453886,-1359635,2008
"twn","astwn","Chinese Taipei",2577308,21759766,-19182458,2008
"vnm","asvnm","Vietnam",4149199,4674373,-525174,2008
"yem","asyem","Yemen",200,3330,-3130,2008
"aut","euaut","Austria",35183379,9820078,25363301,2008
"bel","eubel","Belgium",4780888,5880023,-1099135,2008
"bgr","eubgr","Bulgaria",37574,108965,-71391,2008
"che","euche","Switzerland",1004284,2465003,-1460719,2008
"cze","eucze","Czechia",203834,2865586,-2661752,2008
"deu","eudeu","Germany",21629677,64203707,-42574030,2008
"dnk","eudnk","Denmark",30602,417524,-386922,2008
"esp","euesp","Spain",1786314,10880581,-9094267,2008
"est","euest","Estonia",15655474,7101061,8554413,2008
"fin","eufin","Finland",141903,640673,-498770,2008
"fra","eufra","France",84641293,59134367,25506926,2008
"gbr","eugbr","United Kingdom",8926666,14556519,-5629853,2008
"grc","eugrc","Greece",235,59514,-59279,2008
"hun","euhun","Hungary",174095,3308413,-3134318,2008
"irl","euirl","Ireland",546420,8426951,-7880531,2008
"ita","euita","Italy",12269187,20633147,-8363960,2008
"ltu","eultu","Lithuania",105015,2156497,-2051482,2008
"lux","eulux","Luxembourg",16054,44229,-28175,2008
"lva","eulva","Latvia",400,7192103,-7191703,2008
"mkd","eumkd","North Macedonia",1944,4236,-2292,2008
"nld","eunld","Netherlands",10532970,27442832,-16909862,2008
"nor","eunor","Norway",10160688,875741,9284947,2008
"pol","eupol","Poland",4975019,6758805,-1783786,2008
"prt","euprt","Portugal",18599,336872,-318273,2008
"rus","eurus","Russia",21188374,4806310,16382064,2008
"srb","eusrb","Serbia",1162,60607,-59445,2008
"svk","eusvk","Slovakia",65,227177,-227112,2008
"svn","eusvn","Slovenia",7635,116249,-108614,2008
"swe","euswe","Sweden",388434,2200052,-1811618,2008
"ukr","euukr","Ukraine",247402,205392,42010,2008
"can","nacan","Canada",1619058,3586302,-1967244,2008
"gtm","nagtm","Guatemala",5372,15234,-9862,2008
"mex","namex","Mexico",89669,3676081,-3586412,2008
"nic","nanic","Nicaragua",20,281,-261,2008
"pan","napan","Panama",1675,5801,-4126,2008
"slv","naslv","El Salvador",4486,11431,-6945,2008
"usa","nausa","United States",22302346,163635221,-141332875,2008
"aus","ocaus","Australia",358407,186372,172035,2008
"nzl","ocnzl","New Zealand",1171,23106,-21935,2008
"arg","saarg","Argentina",578920,837421,-258501,2008
"bra","sabra","Brazil",1334136,8114239,-6780103,2008
"chl","sachl","Chile",122,135188,-135066,2008
"col","sacol","Colombia",2228,136641,-134413,2008
"bwa","afbwa","Botswana",103,3792,-3689,2009
"cod","afcod","Democratic Republic of the Congo",61,806,-745,2009
"egy","afegy","Egypt",90,1045541,-1045451,2009
"ken","afken","Kenya",203,8479,-8276,2009
"nam","afnam","Namibia",2328,15,2313,2009
"swz","afswz","Eswatini",9307,5411,3896,2009
"uga","afuga","Uganda",164,11685,-11521,2009
"zaf","afzaf","South Africa",780492,1280435,-499943,2009
"are","asare","United Arab Emirates",7701,375977,-368276,2009
"brn","asbrn","Brunei",45,252754,-252709,2009
"chn","aschn","China",267387703,38882732,228504971,2009
"hkg","ashkg","Hong Kong",3020238,18947942,-15927704,2009
"idn","asidn","Indonesia",116117,1073050,-956933,2009
"ind","asind","India",577460,7461483,-6884023,2009
"irn","asirn","Iran",1085,609489,-608404,2009
"jpn","asjpn","Japan",123236320,132083119,-8846799,2009
"kaz","askaz","Kazakhstan",2127181,699247,1427934,2009
"kgz","askgz","Kyrgyzstan",155589,3012,152577,2009
"kor","askor","South Korea",7341848,52888378,-45546530,2009
"kwt","askwt","Kuwait",41418,152,41266,2009
"lbn","aslbn","Lebanon",19158,69831,-50673,2009
"lka","aslka","Sri Lanka",449773,43338,406435,2009
"mys","asmys","Malaysia",471700,4900734,-4429034,2009
"sau","assau","Saudi Arabia",502,285710,-285208,2009
"sgp","assgp","Singapore",1073803,4651449,-3577646,2009
"tha","astha","Thailand",53256,23126389,-23073133,2009
"tur","astur","Turkey",30853,1027684,-996831,2009
"twn","astwn","Chinese Taipei",2220980,14921194,-12700214,2009
"vnm","asvnm","Vietnam",12435893,19261593,-6825700,2009
"yem","asyem","Yemen",201,10492,-10291,2009
"aut","euaut","Austria",33909667,6413403,27496264,2009
"bel","eubel","Belgium",2622602,4183448,-1560846,2009
"che","euche","Switzerland",791481,1780127,-988646,2009
"cze","eucze","Czechia",212943,2578617,-2365674,2009
"deu","eudeu","Germany",22121875,48546699,-26424824,2009
"dnk","eudnk","Denmark",104395,1182870,-1078475,2009
"esp","euesp","Spain",508421,5216530,-4708109,2009
"est","euest","Estonia",11321907,738151,10583756,2009
"fin","eufin","Finland",3379,800702,-797323,2009
"fra","eufra","France",38083463,36160321,1923142,2009
"gbr","eugbr","United Kingdom",8004053,8561514,-557461,2009
"grc","eugrc","Greece",379,31944,-31565,2009
"hrv","euhrv","Croatia",425,47547,-47122,2009
"hun","euhun","Hungary",2658,1913858,-1911200,2009
"irl","euirl","Ireland",166460,10747335,-10580875,2009
"ita","euita","Italy",15781744,11440703,4341041,2009
"ltu","eultu","Lithuania",80755,91494,-10739,2009
"lux","eulux","Luxembourg",153,3755,-3602,2009
"lva","eulva","Latvia",3839,3181153,-3177314,2009
"nld","eunld","Netherlands",9201855,8979516,222339,2009
"nor","eunor","Norway",13640994,1271952,12369042,2009
"pol","eupol","Poland",2333793,1344763,989030,2009
"prt","euprt","Portugal",24988,233193,-208205,2009
"rou","eurou","Romania",1,110138,-110137,2009
"rus","eurus","Russia",10239250,6109601,4129649,2009
"srb","eusrb","Serbia",74065,45438,28627,2009
"svk","eusvk","Slovakia",522,62666,-62144,2009
"svn","eusvn","Slovenia",22322,89158,-66836,2009
"swe","euswe","Sweden",197141,1673806,-1476665,2009
"ukr","euukr","Ukraine",188807,112336,76471,2009
"can","nacan","Canada",449013,2600726,-2151713,2009
"gtm","nagtm","Guatemala",9148,151000,-141852,2009
"mex","namex","Mexico",126121,2770075,-2643954,2009
"pan","napan","Panama",24167,9751,14416,2009
"slv","naslv","El Salvador",6752,7885,-1133,2009
"usa","nausa","United States",18400399,107494820,-89094421,2009
"aus","ocaus","Australia",185701,257446,-71745,2009
"nzl","ocnzl","New Zealand",4760,47258,-42498,2009
"arg","saarg","Argentina",847851,927821,-79970,2009
"bra","sabra","Brazil",795402,5214523,-4419121,2009
"col","sacol","Colombia",532,327355,-326823,2009
"dza","afdza","Algeria",3074,45273,-42199,2010
"egy","afegy","Egypt",2118,635036,-632918,2010
"ken","afken","Kenya",53,7044,-6991,2010
"mli","afmli","Mali",101,6005,-5904,2010
"nam","afnam","Namibia",17111,845,16266,2010
"tza","aftza","Tanzania",243,16724,-16481,2010
"zaf","afzaf","South Africa",1227380,3039298,-1811918,2010
"are","asare","United Arab Emirates",78989,469513,-390524,2010
"arm","asarm","Armenia",2759,1660,1099,2010
"brn","asbrn","Brunei",96,31535,-31439,2010
"btn","asbtn","Bhutan",1485,59,1426,2010
"chn","aschn","China",781445170,43231758,738213412,2010
"hkg","ashkg","Hong Kong",23608084,24454117,-846033,2010
"idn","asidn","Indonesia",208989,4694320,-4485331,2010
"ind","asind","India",1481784,11803382,-10321598,2010
"irn","asirn","Iran",661213,705852,-44638.9999999999,2010
"isr","asisr","Israel",25704,1154080,-1128376,2010
"jor","asjor","Jordan",36340,9610,26730,2010
"jpn","asjpn","Japan",159235044,453496539,-294261495,2010
"kaz","askaz","Kazakhstan",4943778,956073,3987705,2010
"kgz","askgz","Kyrgyzstan",430000,877,429123,2010
"kor","askor","South Korea",11240370,129396106,-118155736,2010
"lbn","aslbn","Lebanon",2296,35520,-33224,2010
"lka","aslka","Sri Lanka",250175,23384,226791,2010
"mys","asmys","Malaysia",1741864,7384115,-5642251,2010
"pak","aspak","Pakistan",2014,27678,-25664,2010
"sau","assau","Saudi Arabia",44190,555701,-511511,2010
"sgp","assgp","Singapore",2424435,23876525,-21452090,2010
"tha","astha","Thailand",1096010,27385626,-26289616,2010
"tur","astur","Turkey",159177,2469576,-2310399,2010
"twn","astwn","Chinese Taipei",3032431,30257218,-27224787,2010
"vnm","asvnm","Vietnam",4461825,25418603,-20956778,2010
"aut","euaut","Austria",40908919,11872760,29036159,2010
"bel","eubel","Belgium",6088054,7986908,-1898854,2010
"che","euche","Switzerland",976631,2917377,-1940746,2010
"cze","eucze","Czechia",260074,3898166,-3638092,2010
"deu","eudeu","Germany",32400466,71888702,-39488236,2010
"dnk","eudnk","Denmark",16974,582863,-565889,2010
"esp","euesp","Spain",2419959,11189687,-8769728,2010
"est","euest","Estonia",13474069,5532084,7941985,2010
"fin","eufin","Finland",319447,1258857,-939410,2010
"fra","eufra","France",60491591,68174337,-7682746,2010
"gbr","eugbr","United Kingdom",10734056,16209372,-5475316,2010
"grc","eugrc","Greece",2685,39911,-37226,2010
"hrv","euhrv","Croatia",362,17679,-17317,2010
"hun","euhun","Hungary",24830,2742489,-2717659,2010
"irl","euirl","Ireland",2407754,9464655,-7056901,2010
"ita","euita","Italy",15680163,42611227,-26931064,2010
"ltu","eultu","Lithuania",236204,187578,48626,2010
"lva","eulva","Latvia",182259,212949,-30690,2010
"nld","eunld","Netherlands",8932693,34104862,-25172169,2010
"nor","eunor","Norway",16969470,263404,16706066,2010
"pol","eupol","Poland",1142660,6991481,-5848821,2010
"prt","euprt","Portugal",84939,680228,-595289,2010
"rus","eurus","Russia",19061753,4980437,14081316,2010
"srb","eusrb","Serbia",74,61111,-61037,2010
"svk","eusvk","Slovakia",4427,94598,-90171,2010
"svn","eusvn","Slovenia",22899,151934,-129035,2010
"swe","euswe","Sweden",109371,1728946,-1619575,2010
"ukr","euukr","Ukraine",169793,332735,-162942,2010
"can","nacan","Canada",11169533,20820591,-9651058,2010
"cri","nacri","Costa Rica",9000,51985,-42985,2010
"gtm","nagtm","Guatemala",8618,10767,-2149,2010
"jam","najam","Jamaica",2214,332312,-330098,2010
"mex","namex","Mexico",75530,5974917,-5899387,2010
"pan","napan","Panama",2781,13944,-11163,2010
"slv","naslv","El Salvador",13886,40276,-26390,2010
"usa","nausa","United States",55660121,154383488,-98723367,2010
"aus","ocaus","Australia",268040,554802,-286762,2010
"fji","ocfji","Fiji",2047,3768,-1721,2010
"nzl","ocnzl","New Zealand",4963,24045,-19082,2010
"arg","saarg","Argentina",1146744,975515,171229,2010
"bra","sabra","Brazil",370749,6100118,-5729369,2010
"chl","sachl","Chile",2775,124513,-121738,2010
"bwa","afbwa","Botswana",20,702,-682,2011
"civ","afciv","Cote d'Ivoire",11458,179,11279,2011
"dza","afdza","Algeria",1526,29106,-27580,2011
"egy","afegy","Egypt",748,1424019,-1423271,2011
"ken","afken","Kenya",25,12179,-12154,2011
"nam","afnam","Namibia",84,25769,-25685,2011
"zaf","afzaf","South Africa",6799332,15366069,-8566737,2011
"are","asare","United Arab Emirates",897332,816351,80981,2011
"arm","asarm","Armenia",1678,1939,-261,2011
"btn","asbtn","Bhutan",272,458,-186,2011
"chn","aschn","China",2217682751,67975038,2149707713,2011
"cyp","ascyp","Cyprus",82940,6149,76791,2011
"hkg","ashkg","Hong Kong",26027975,78468415,-52440440,2011
"idn","asidn","Indonesia",7010178,4582470,2427708,2011
"ind","asind","India",6525158,23829305,-17304147,2011
"irn","asirn","Iran",721526,3146233,-2424707,2011
"isr","asisr","Israel",5754,2040867,-2035113,2011
"jor","asjor","Jordan",150253,18958,131295,2011
"jpn","asjpn","Japan",273469788,1325212080,-1051742292,2011
"kaz","askaz","Kazakhstan",16539662,6980959,9558703,2011
"kgz","askgz","Kyrgyzstan",764457,136,764321,2011
"kor","askor","South Korea",34171566,163319995,-129148429,2011
"lao","aslao","Laos",4020011,4736276,-716265.000000001,2011
"lbn","aslbn","Lebanon",1400,8134,-6734,2011
"lka","aslka","Sri Lanka",698495,42836,655659,2011
"mys","asmys","Malaysia",10253398,36167163,-25913765,2011
"omn","asomn","Oman",63108,91773,-28665,2011
"pak","aspak","Pakistan",164348,34528,129820,2011
"sau","assau","Saudi Arabia",42074,997576,-955502,2011
"sgp","assgp","Singapore",6237458,40229998,-33992540,2011
"tha","astha","Thailand",1621735,54739049,-53117314,2011
"tur","astur","Turkey",437252,6297063,-5859811,2011
"twn","astwn","Chinese Taipei",15356525,57503185,-42146660,2011
"vnm","asvnm","Vietnam",74201799,91282152,-17080353,2011
"alb","eualb","Albania",3405,2754,651,2011
"aut","euaut","Austria",89825186,58552777,31272409,2011
"bel","eubel","Belgium",9691682,22673526,-12981844,2011
"bgr","eubgr","Bulgaria",23525,390266,-366741,2011
"bih","eubih","Bosnia and Herzegovina",423654,1370,422284,2011
"blr","eublr","Belarus",27300,1623607,-1596307,2011
"che","euche","Switzerland",2463564,8600486,-6136922,2011
"cze","eucze","Czechia",366938,12621548,-12254610,2011
"deu","eudeu","Germany",74356053,237971149,-163615096,2011
"dnk","eudnk","Denmark",88780,1002634,-913854,2011
"esp","euesp","Spain",4350346,19021491,-14671145,2011
"est","euest","Estonia",92686244,71053336,21632908,2011
"fin","eufin","Finland",2883441,2995452,-112011,2011
"fra","eufra","France",163952074,229206283,-65254209,2011
"gbr","eugbr","United Kingdom",22048614,40673781,-18625167,2011
"grc","eugrc","Greece",4907,360359,-355452,2011
"hrv","euhrv","Croatia",1962,273829,-271867,2011
"hun","euhun","Hungary",132788,7137276,-7004488,2011
"irl","euirl","Ireland",4537227,20386033,-15848806,2011
"ita","euita","Italy",31054128,55946636,-24892508,2011
"ltu","eultu","Lithuania",674257,636541,37716,2011
"lux","eulux","Luxembourg",1374630,1238787,135843,2011
"lva","eulva","Latvia",24577,12784783,-12760206,2011
"mlt","eumlt","Malta",3342,6663,-3321,2011
"nld","eunld","Netherlands",21372762,54986544,-33613782,2011
"nor","eunor","Norway",24049911,1701181,22348730,2011
"pol","eupol","Poland",9224058,11045273,-1821215,2011
"prt","euprt","Portugal",153828,1886814,-1732986,2011
"rou","eurou","Romania",209217,129841,79376,2011
"rus","eurus","Russia",77864768,17116751,60748017,2011
"svk","eusvk","Slovakia",17486507,851924,16634583,2011
"svn","eusvn","Slovenia",29071,492124,-463053,2011
"swe","euswe","Sweden",93547,3697004,-3603457,2011
"ukr","euukr","Ukraine",483189,292000,191189,2011
"can","nacan","Canada",98319565,47991396,50328169,2011
"cri","nacri","Costa Rica",625,37690,-37065,2011
"gtm","nagtm","Guatemala",6913,32509,-25596,2011
"mex","namex","Mexico",15360,10873200,-10857840,2011
"slv","naslv","El Salvador",9527,45225,-35698,2011
"usa","nausa","United States",251470416,707585750,-456115334,2011
"aus","ocaus","Australia",1682359,1625985,56374,2011
"nzl","ocnzl","New Zealand",4014,109836,-105822,2011
"arg","saarg","Argentina",1412129,1972409,-560280,2011
"bra","sabra","Brazil",23780,27151906,-27128126,2011
"col","sacol","Colombia",2487,414355,-411868,2011
"per","saper","Peru",2889,568562,-565673,2011
"sur","sasur","Suriname",675,468,207,2011
"bwa","afbwa","Botswana",74,67095,-67021,2012
"egy","afegy","Egypt",601,3061078,-3060477,2012
"gha","afgha","Ghana",5706,7408,-1702,2012
"ken","afken","Kenya",96,34371,-34275,2012
"mdg","afmdg","Madagascar",1554,1333,221,2012
"moz","afmoz","Mozambique",3412,79,3333,2012
"nam","afnam","Namibia",244,3041,-2797,2012
"nga","afnga","Nigeria",13,478,-465,2012
"tza","aftza","Tanzania",51,35037,-34986,2012
"uga","afuga","Uganda",1202,7917,-6715,2012
"zaf","afzaf","South Africa",5023123,9430372,-4407249,2012
"zwe","afzwe","Zimbabwe",10,11532,-11522,2012
"are","asare","United Arab Emirates",946675,942000,4675.00000000012,2012
"chn","aschn","China",870541440,45362660,825178780,2012
"cyp","ascyp","Cyprus",290054,9090,280964,2012
"hkg","ashkg","Hong Kong",40493433,83821049,-43327616,2012
"idn","asidn","Indonesia",8109,7748379,-7740270,2012
"ind","asind","India",2375299,11891045,-9515746,2012
"isr","asisr","Israel",6827,2014656,-2007829,2012
"jpn","asjpn","Japan",269085835,382151875,-113066040,2012
"kaz","askaz","Kazakhstan",6880026,83572,6796454,2012
"kor","askor","South Korea",26566751,104467402,-77900651,2012
"lao","aslao","Laos",5837710,44420,5793290,2012
"lbn","aslbn","Lebanon",79675,5188,74487,2012
"lka","aslka","Sri Lanka",975786,77508,898278,2012
"mmr","asmmr","Burma",720881,5882,714999,2012
"mys","asmys","Malaysia",2107683,28079110,-25971427,2012
"phl","asphl","Philippines",2879456,21575248,-18695792,2012
"sau","assau","Saudi Arabia",3860,1278779,-1274919,2012
"sgp","assgp","Singapore",10524202,28430359,-17906157,2012
"tha","astha","Thailand",2899061,14050387,-11151326,2012
"tur","astur","Turkey",64029,3207425,-3143396,2012
"twn","astwn","Chinese Taipei",2978974,59940500,-56961526,2012
"vnm","asvnm","Vietnam",12561405,60412355,-47850950,2012
"aut","euaut","Austria",96063676,27054362,69009314,2012
"bel","eubel","Belgium",3338815,22242194,-18903379,2012
"bgr","eubgr","Bulgaria",8295,31171,-22876,2012
"blr","eublr","Belarus",81400,1048723,-967323,2012
"che","euche","Switzerland",1276284,6132140,-4855856,2012
"cze","eucze","Czechia",293381,21672825,-21379444,2012
"deu","eudeu","Germany",70744151,132829673,-62085522,2012
"dnk","eudnk","Denmark",26375,1235353,-1208978,2012
"esp","euesp","Spain",2509553,20493671,-17984118,2012
"est","euest","Estonia",64845052,38117491,26727561,2012
"fin","eufin","Finland",6025,1126562,-1120537,2012
"fra","eufra","France",186965520,203493108,-16527588,2012
"gbr","eugbr","United Kingdom",19163203,20726341,-1563138,2012
"grc","eugrc","Greece",258928,90523,168405,2012
"hrv","euhrv","Croatia",22,242642,-242620,2012
"hun","euhun","Hungary",26752,4199617,-4172865,2012
"irl","euirl","Ireland",2222813,17010093,-14787280,2012
"ita","euita","Italy",33740905,49756750,-16015845,2012
"ltu","eultu","Lithuania",347301,452380,-105079,2012
"lux","eulux","Luxembourg",2351031,770287,1580744,2012
"lva","eulva","Latvia",100,5012843,-5012743,2012
"mkd","eumkd","North Macedonia",48487,347324,-298837,2012
"nld","eunld","Netherlands",15457193,44583964,-29126771,2012
"nor","eunor","Norway",32132741,1381838,30750903,2012
"pol","eupol","Poland",1696915,4024766,-2327851,2012
"prt","euprt","Portugal",51614,961144,-909530,2012
"rou","eurou","Romania",254350,126365,127985,2012
"rus","eurus","Russia",37622791,12787042,24835749,2012
"srb","eusrb","Serbia",23393,67252,-43859,2012
"svn","eusvn","Slovenia",8362,1167457,-1159095,2012
"swe","euswe","Sweden",344275,3964807,-3620532,2012
"ukr","euukr","Ukraine",123960,522484,-398524,2012
"can","nacan","Canada",54557875,16667796,37890079,2012
"cri","nacri","Costa Rica",11518,77788,-66270,2012
"cub","nacub","Cuba",124,258238,-258114,2012
"gtm","nagtm","Guatemala",27759,13695,14064,2012
"mex","namex","Mexico",81442,13904319,-13822877,2012
"slv","naslv","El Salvador",10891,37881,-26990,2012
"tto","natto","Trinidad and Tobago",2280,2832,-552,2012
"usa","nausa","United States",108062675,405131591,-297068916,2012
"aus","ocaus","Australia",82196,2047674,-1965478,2012
"nzl","ocnzl","New Zealand",2688,93278,-90590,2012
"arg","saarg","Argentina",116496,1523306,-1406810,2012
"bra","sabra","Brazil",8650,25087879,-25079229,2012
"col","sacol","Colombia",3052,636295,-633243,2012
"per","saper","Peru",10461,455869,-445408,2012
"bwa","afbwa","Botswana",737,4605,-3868,2013
"ken","afken","Kenya",463,18859,-18396,2013
"nam","afnam","Namibia",205,26313,-26108,2013
"tza","aftza","Tanzania",467,1968,-1501,2013
"zaf","afzaf","South Africa",3105711,2145664,960047,2013
"zmb","afzmb","Zambia",1645,667,978,2013
"are","asare","United Arab Emirates",221621,895559,-673938,2013
"chn","aschn","China",650377303,199721907,450655396,2013
"hkg","ashkg","Hong Kong",68375167,121636826,-53261659,2013
"idn","asidn","Indonesia",5972,2775948,-2769976,2013
"ind","asind","India",3463330,9607863,-6144533,2013
"irn","asirn","Iran",233100,453367,-220267,2013
"isr","asisr","Israel",7898,1755157,-1747259,2013
"jor","asjor","Jordan",81008,3057,77951,2013
"jpn","asjpn","Japan",185821286,190716196,-4894910,2013
"kaz","askaz","Kazakhstan",5771385,6034151,-262766.000000001,2013
"kgz","askgz","Kyrgyzstan",76567,414,76153,2013
"kor","askor","South Korea",9965551,71874424,-61908873,2013
"lao","aslao","Laos",3586724,207594,3379130,2013
"lka","aslka","Sri Lanka",563769,40728,523041,2013
"mmr","asmmr","Burma",1791621,191246,1600375,2013
"mys","asmys","Malaysia",15561192,8307992,7253200,2013
"phl","asphl","Philippines",7392433,10173329,-2780896,2013
"sgp","assgp","Singapore",16705372,12861568,3843804,2013
"tha","astha","Thailand",605779,5062222,-4456443,2013
"tur","astur","Turkey",152177,2718993,-2566816,2013
"twn","astwn","Chinese Taipei",2977962,44891734,-41913772,2013
"vnm","asvnm","Vietnam",11435138,69725304,-58290166,2013
"alb","eualb","Albania",5966,1892,4074,2013
"aut","euaut","Austria",60251786,8281479,51970307,2013
"bel","eubel","Belgium",3044762,5085537,-2040775,2013
"bgr","eubgr","Bulgaria",6952,140951,-133999,2013
"blr","eublr","Belarus",30800,717771,-686971,2013
"che","euche","Switzerland",797957,5900976,-5103019,2013
"cze","eucze","Czechia",284085,12517290,-12233205,2013
"deu","eudeu","Germany",43006782,104742671,-61735889,2013
"dnk","eudnk","Denmark",20975,1059060,-1038085,2013
"esp","euesp","Spain",1191866,26583595,-25391729,2013
"est","euest","Estonia",42602153,14382537,28219616,2013
"fin","eufin","Finland",1009152,1047749,-38597,2013
"fra","eufra","France",102724032,75911422,26812610,2013
"gbr","eugbr","United Kingdom",11891417,23206415,-11314998,2013
"grc","eugrc","Greece",1892,96533,-94641,2013
"hrv","euhrv","Croatia",1135,8380,-7245,2013
"hun","euhun","Hungary",24730,2544497,-2519767,2013
"irl","euirl","Ireland",17889,25228205,-25210316,2013
"ita","euita","Italy",42356524,38306405,4050119,2013
"ltu","eultu","Lithuania",2062757,850149,1212608,2013
"lux","eulux","Luxembourg",348701,178585,170116,2013
"mkd","eumkd","North Macedonia",22705,1707866,-1685161,2013
"nld","eunld","Netherlands",10050957,26925240,-16874283,2013
"nor","eunor","Norway",24445519,4727274,19718245,2013
"pol","eupol","Poland",337163,2408874,-2071711,2013
"prt","euprt","Portugal",33526,1454170,-1420644,2013
"rou","eurou","Romania",918,167101,-166183,2013
"rus","eurus","Russia",18615826,9877449,8738377,2013
"srb","eusrb","Serbia",1048,44941,-43893,2013
"svn","eusvn","Slovenia",25746,1014451,-988705,2013
"swe","euswe","Sweden",251558,999820,-748262,2013
"ukr","euukr","Ukraine",122172,196761,-74589,2013
"brb","nabrb","Barbados",55805,807,54998,2013
"can","nacan","Canada",11833793,7065965,4767828,2013
"gtm","nagtm","Guatemala",27502,11205,16297,2013
"hnd","nahnd","Honduras",35,3096,-3061,2013
"mex","namex","Mexico",625120,7417199,-6792079,2013
"slv","naslv","El Salvador",9161,44001,-34840,2013
"usa","nausa","United States",70579058,246424046,-175844988,2013
"aus","ocaus","Australia",274678,634747,-360069,2013
"nzl","ocnzl","New Zealand",10942,16971,-6029,2013
"bra","sabra","Brazil",77302,10898163,-10820861,2013
"chl","sachl","Chile",1397,160719,-159322,2013
"col","sacol","Colombia",25543,214127,-188584,2013
"per","saper","Peru",33703,397865,-364162,2013
"egy","afegy","Egypt",33,821751,-821718,2014
"mwi","afmwi","Malawi",27,6528,-6501,2014
"nam","afnam","Namibia",4915,13038,-8123,2014
"zaf","afzaf","South Africa",4454017,5628831,-1174814,2014
"are","asare","United Arab Emirates",2691241,364112,2327129,2014
"bhr","asbhr","Bahrain",11618,44796,-33178,2014
"chn","aschn","China",350031448,70534737,279496711,2014
"hkg","ashkg","Hong Kong",29572548,16412446,13160102,2014
"idn","asidn","Indonesia",5775,3636550,-3630775,2014
"ind","asind","India",4577553,9688576,-5111023,2014
"irn","asirn","Iran",130536,408035,-277499,2014
"isr","asisr","Israel",677,637201,-636524,2014
"jor","asjor","Jordan",93805,22453,71352,2014
"jpn","asjpn","Japan",183192170,224024191,-40832021,2014
"kaz","askaz","Kazakhstan",14660114,3964613,10695501,2014
"kor","askor","South Korea",8817448,49998295,-41180847,2014
"lao","aslao","Laos",1660257,35191,1625066,2014
"lka","aslka","Sri Lanka",1192779,40725,1152054,2014
"mmr","asmmr","Burma",1504590,170306,1334284,2014
"mys","asmys","Malaysia",98417130,8963295,89453835,2014
"pak","aspak","Pakistan",63095,29778,33317,2014
"phl","asphl","Philippines",21930004,17016833,4913171,2014
"prk","asprk","North Korea",22485,64145,-41660,2014
"sau","assau","Saudi Arabia",1726,271423,-269697,2014
"sgp","assgp","Singapore",2095013,3612771,-1517758,2014
"tha","astha","Thailand",4014787,26511333,-22496546,2014
"tur","astur","Turkey",114492,2250154,-2135662,2014
"twn","astwn","Chinese Taipei",2638306,42761805,-40123499,2014
"vnm","asvnm","Vietnam",8701261,111283536,-102582275,2014
"yem","asyem","Yemen",35722,27,35695,2014
"aut","euaut","Austria",42526731,7206407,35320324,2014
"bel","eubel","Belgium",1123127,2605731,-1482604,2014
"bgr","eubgr","Bulgaria",460184,146952,313232,2014
"blr","eublr","Belarus",600,497706,-497106,2014
"che","euche","Switzerland",853224,5466793,-4613569,2014
"cze","eucze","Czechia",341530,6875313,-6533783,2014
"deu","eudeu","Germany",38147490,68447268,-30299778,2014
"dnk","eudnk","Denmark",13025,780881,-767856,2014
"esp","euesp","Spain",1473099,23594146,-22121047,2014
"est","euest","Estonia",33834759,15608064,18226695,2014
"fin","eufin","Finland",780936,524229,256707,2014
"fra","eufra","France",73775351,30918915,42856436,2014
"gbr","eugbr","United Kingdom",8417369,17321792,-8904423,2014
"grc","eugrc","Greece",368695,31417,337278,2014
"hrv","euhrv","Croatia",231,14063,-13832,2014
"hun","euhun","Hungary",33728,2696137,-2662409,2014
"irl","euirl","Ireland",21136,23318981,-23297845,2014
"ita","euita","Italy",25019988,20858532,4161456,2014
"ltu","eultu","Lithuania",115325,2687530,-2572205,2014
"lux","eulux","Luxembourg",265605,427201,-161596,2014
"lva","eulva","Latvia",128808,4821357,-4692549,2014
"mkd","eumkd","North Macedonia",397923,4502997,-4105074,2014
"nld","eunld","Netherlands",10332379,27418892,-17086513,2014
"nor","eunor","Norway",20560524,1520294,19040230,2014
"pol","eupol","Poland",793705,2602165,-1808460,2014
"prt","euprt","Portugal",5507,1216937,-1211430,2014
"rus","eurus","Russia",23754490,13976559,9777931,2014
"svk","eusvk","Slovakia",1026,371914,-370888,2014
"svn","eusvn","Slovenia",66279,314750,-248471,2014
"swe","euswe","Sweden",149778,1858444,-1708666,2014
"ukr","euukr","Ukraine",160125,280084,-119959,2014
"can","nacan","Canada",2038210,4514723,-2476513,2014
"gtm","nagtm","Guatemala",15818,56183,-40365,2014
"jam","najam","Jamaica",1227,27890,-26663,2014
"mex","namex","Mexico",19878,5446077,-5426199,2014
"pan","napan","Panama",5000,75719,-70719,2014
"slv","naslv","El Salvador",8589,225793,-217204,2014
"usa","nausa","United States",54362244,172877868,-118515624,2014
"aus","ocaus","Australia",160887,668060,-507173,2014
"nzl","ocnzl","New Zealand",2263,65108,-62845,2014
"arg","saarg","Argentina",40380,715974,-675594,2014
"bra","sabra","Brazil",4380,6135101,-6130721,2014
"chl","sachl","Chile",3437,190312,-186875,2014
"col","sacol","Colombia",137257,178164,-40907,2014
"ecu","saecu","Ecuador",7791,15769,-7978,2014
"per","saper","Peru",11524,142216,-130692,2014
"egy","afegy","Egypt",20743,1631675,-1610932,2015
"eth","afeth","Ethiopia",75,948,-873,2015
"ken","afken","Kenya",1356,3758,-2402,2015
"mwi","afmwi","Malawi",47,46661,-46614,2015
"nam","afnam","Namibia",8,2031,-2023,2015
"nga","afnga","Nigeria",17,219259,-219242,2015
"zaf","afzaf","South Africa",2956946,8417881,-5460935,2015
"zmb","afzmb","Zambia",9,51501,-51492,2015
"are","asare","United Arab Emirates",6393636,899404,5494232,2015
"chn","aschn","China",324124712,90455348,233669364,2015
"cyp","ascyp","Cyprus",7,4106,-4099,2015
"hkg","ashkg","Hong Kong",13104197,9281482,3822715,2015
"idn","asidn","Indonesia",5562,1084676,-1079114,2015
"ind","asind","India",1980496,7434889,-5454393,2015
"irn","asirn","Iran",94685,447732,-353047,2015
"isr","asisr","Israel",1982,710636,-708654,2015
"jor","asjor","Jordan",30885,66471,-35586,2015
"jpn","asjpn","Japan",173600878,191745305,-18144427,2015
"kaz","askaz","Kazakhstan",10706270,3863043,6843227,2015
"kor","askor","South Korea",12612589,59504244,-46891655,2015
"lao","aslao","Laos",27,14209,-14182,2015
"lbn","aslbn","Lebanon",199,8754,-8555,2015
"lka","aslka","Sri Lanka",894802,47456,847346,2015
"mmr","asmmr","Burma",6118605,617639,5500966,2015
"mys","asmys","Malaysia",109638984,5549972,104089012,2015
"pak","aspak","Pakistan",217475,245396,-27921,2015
"phl","asphl","Philippines",5499410,8507775,-3008365,2015
"sgp","assgp","Singapore",1000307,3385643,-2385336,2015
"tha","astha","Thailand",4206626,40065369,-35858743,2015
"tur","astur","Turkey",84569,2079184,-1994615,2015
"twn","astwn","Chinese Taipei",3109514,30026218,-26916704,2015
"vnm","asvnm","Vietnam",5483509,107041799,-101558290,2015
"aut","euaut","Austria",34551001,6142574,28408427,2015
"bel","eubel","Belgium",1101477,1228434,-126957,2015
"bgr","eubgr","Bulgaria",3687,116752,-113065,2015
"blr","eublr","Belarus",11700,345420,-333720,2015
"che","euche","Switzerland",823465,6653785,-5830320,2015
"cze","eucze","Czechia",264923,5387375,-5122452,2015
"deu","eudeu","Germany",41685589,71053560,-29367971,2015
"dnk","eudnk","Denmark",96729,598150,-501421,2015
"esp","euesp","Spain",673971,14596162,-13922191,2015
"est","euest","Estonia",31094671,5279775,25814896,2015
"fin","eufin","Finland",2897,884519,-881622,2015
"fra","eufra","France",77470723,29961385,47509338,2015
"gbr","eugbr","United Kingdom",8454390,21592544,-13138154,2015
"grc","eugrc","Greece",1031,30430,-29399,2015
"hrv","euhrv","Croatia",301,4654,-4353,2015
"hun","euhun","Hungary",43211,822856,-779645,2015
"irl","euirl","Ireland",2983,26011735,-26008752,2015
"ita","euita","Italy",18720887,14800460,3920427,2015
"ltu","eultu","Lithuania",37136,46032,-8896,2015
"lux","eulux","Luxembourg",219800,373272,-153472,2015
"lva","eulva","Latvia",183746,286765,-103019,2015
"mkd","eumkd","North Macedonia",144421,6268098,-6123677,2015
"mlt","eumlt","Malta",4,5563,-5559,2015
"nld","eunld","Netherlands",8818701,35655402,-26836701,2015
"nor","eunor","Norway",27665374,450406,27214968,2015
"pol","eupol","Poland",656256,2576592,-1920336,2015
"prt","euprt","Portugal",2859,769594,-766735,2015
"rou","eurou","Romania",30192,122314,-92122,2015
"rus","eurus","Russia",14820084,14380673,439411,2015
"srb","eusrb","Serbia",597,84345,-83748,2015
"svk","eusvk","Slovakia",754,186206,-185452,2015
"svn","eusvn","Slovenia",318224,305123,13101,2015
"swe","euswe","Sweden",125591,801323,-675732,2015
"ukr","euukr","Ukraine",186867,176300,10567,2015
"can","nacan","Canada",1062972,1755209,-692237,2015
"dom","nadom","Dominican Republic",25811,16956,8855,2015
"gtm","nagtm","Guatemala",23467,18523,4944,2015
"hnd","nahnd","Honduras",30049,1756,28293,2015
"mex","namex","Mexico",199160,5116946,-4917786,2015
"pan","napan","Panama",679,32461,-31782,2015
"slv","naslv","El Salvador",28034,208140,-180106,2015
"usa","nausa","United States",60773447,153539997,-92766550,2015
"aus","ocaus","Australia",182018,559085,-377067,2015
"nzl","ocnzl","New Zealand",352,16823,-16471,2015
"arg","saarg","Argentina",100,358540,-358440,2015
"bra","sabra","Brazil",21012,5433436,-5412424,2015
"chl","sachl","Chile",141769,154669,-12900,2015
"col","sacol","Colombia",1585,170708,-169123,2015
"per","saper","Peru",6086,289583,-283497,2015
"egy","afegy","Egypt",10357,157780,-147423,2016
"ken","afken","Kenya",1146,3953,-2807,2016
"mar","afmar","Morocco",418,89148,-88730,2016
"mus","afmus","Mauritius",242,69694,-69452,2016
"nam","afnam","Namibia",187,1804,-1617,2016
"sle","afsle","Sierra Leone",35,72894,-72859,2016
"uga","afuga","Uganda",192,778,-586,2016
"zaf","afzaf","South Africa",3438168,9604192,-6166024,2016
"are","asare","United Arab Emirates",10463489,583483,9880006,2016
"bgd","asbgd","Bangladesh",1630,86521,-84891,2016
"chn","aschn","China",385072711,89948729,295123982,2016
"cyp","ascyp","Cyprus",68172,11305,56867,2016
"hkg","ashkg","Hong Kong",87649862,7646976,80002886,2016
"ind","asind","India",5841579,4902626,938953,2016
"irn","asirn","Iran",250187,127735,122452,2016
"isr","asisr","Israel",633,424320,-423687,2016
"jor","asjor","Jordan",72000,43673,28327,2016
"jpn","asjpn","Japan",182341365,181470550,870815,2016
"kaz","askaz","Kazakhstan",848684,54631,794053,2016
"kor","askor","South Korea",10126669,65476134,-55349465,2016
"lka","aslka","Sri Lanka",408275,32400,375875,2016
"mmr","asmmr","Burma",2638481,1189,2637292,2016
"mys","asmys","Malaysia",137650566,8725145,128925421,2016
"pak","aspak","Pakistan",125806,198024,-72218,2016
"phl","asphl","Philippines",2582838,9791652,-7208814,2016
"sau","assau","Saudi Arabia",165,173232,-173067,2016
"sgp","assgp","Singapore",2306084,12680951,-10374867,2016
"tha","astha","Thailand",237162,27690496,-27453334,2016
"tur","astur","Turkey",87976,2232460,-2144484,2016
"twn","astwn","Chinese Taipei",20194667,200757196,-180562529,2016
"vnm","asvnm","Vietnam",8204497,87968538,-79764041,2016
"aut","euaut","Austria",28495315,4337921,24157394,2016
"bel","eubel","Belgium",630893,1812963,-1182070,2016
"bgr","eubgr","Bulgaria",41,93817,-93776,2016
"blr","eublr","Belarus",3270,304639,-301369,2016
"che","euche","Switzerland",936051,4782016,-3845965,2016
"cze","eucze","Czechia",165080,4898006,-4732926,2016
"deu","eudeu","Germany",21614035,46944595,-25330560,2016
"dnk","eudnk","Denmark",27262,149001,-121739,2016
"esp","euesp","Spain",820551,14782097,-13961546,2016
"est","euest","Estonia",21885277,12076004,9809273,2016
"fin","eufin","Finland",443806,601799,-157993,2016
"fra","eufra","France",79021987,31303994,47717993,2016
"gbr","eugbr","United Kingdom",8491387,15771824,-7280437,2016
"grc","eugrc","Greece",225,24426,-24201,2016
"hrv","euhrv","Croatia",707,3855,-3148,2016
"hun","euhun","Hungary",26423,1892316,-1865893,2016
"irl","euirl","Ireland",531,1770391,-1769860,2016
"ita","euita","Italy",21102428,16825334,4277094,2016
"ltu","eultu","Lithuania",253997,67310,186687,2016
"lux","eulux","Luxembourg",161697,95294,66403,2016
"lva","eulva","Latvia",33461,37908,-4447,2016
"mkd","eumkd","North Macedonia",183304,6731183,-6547879,2016
"nld","eunld","Netherlands",2256664,52231025,-49974361,2016
"nor","eunor","Norway",3096831,451959,2644872,2016
"pol","eupol","Poland",383903,5396247,-5012344,2016
"prt","euprt","Portugal",6914,382831,-375917,2016
"rou","eurou","Romania",678,151308,-150630,2016
"rus","eurus","Russia",14601133,19169972,-4568839,2016
"srb","eusrb","Serbia",445,173624,-173179,2016
"svk","eusvk","Slovakia",774,128630,-127856,2016
"svn","eusvn","Slovenia",187884,1049689,-861805,2016
"swe","euswe","Sweden",148000,547507,-399507,2016
"ukr","euukr","Ukraine",156166,150215,5951.00000000003,2016
"can","nacan","Canada",952437,2649139,-1696702,2016
"cri","nacri","Costa Rica",240,44812,-44572,2016
"dom","nadom","Dominican Republic",13804,22074,-8270,2016
"gtm","nagtm","Guatemala",21271,30084,-8813,2016
"hnd","nahnd","Honduras",16819,1280,15539,2016
"mex","namex","Mexico",71272,4607363,-4536091,2016
"pan","napan","Panama",480,8458,-7978,2016
"slv","naslv","El Salvador",7869,176147,-168278,2016
"usa","nausa","United States",19564056,116242644,-96678588,2016
"aus","ocaus","Australia",139865,494109,-354244,2016
"bra","sabra","Brazil",156356,3648908,-3492552,2016
"chl","sachl","Chile",19240,107024,-87784,2016
"col","sacol","Colombia",646,50166,-49520,2016
"per","saper","Peru",3459,233900,-230441,2016
"egy","afegy","Egypt",446,357652,-357206,2017
"nam","afnam","Namibia",34400,3581,30819,2017
"nga","afnga","Nigeria",184,365934,-365750,2017
"zaf","afzaf","South Africa",3092611,7079881,-3987270,2017
"are","asare","United Arab Emirates",15220904,1017383,14203521,2017
"chn","aschn","China",348571051,168551766,180019285,2017
"cyp","ascyp","Cyprus",516,1343,-827,2017
"hkg","ashkg","Hong Kong",2162529,8095626,-5933097,2017
"ind","asind","India",19570814,9352450,10218364,2017
"isr","asisr","Israel",57639,963017,-905378,2017
"jor","asjor","Jordan",1565,9061,-7496,2017
"jpn","asjpn","Japan",207866652,229839328,-21972676,2017
"kaz","askaz","Kazakhstan",1056856,47358,1009498,2017
"kor","askor","South Korea",11508052,65462001,-53953949,2017
"lka","aslka","Sri Lanka",591066,21297,569769,2017
"mmr","asmmr","Burma",12395797,484912,11910885,2017
"mys","asmys","Malaysia",235327806,12591923,222735883,2017
"pak","aspak","Pakistan",282173,239486,42687,2017
"sgp","assgp","Singapore",10557013,22200877,-11643864,2017
"tha","astha","Thailand",42957,38361241,-38318284,2017
"tur","astur","Turkey",59694,1906954,-1847260,2017
"twn","astwn","Chinese Taipei",3259174,63429402,-60170228,2017
"vnm","asvnm","Vietnam",9104698,111409557,-102304859,2017
"aut","euaut","Austria",18341857,4372418,13969439,2017
"bel","eubel","Belgium",1059020,1098941,-39921,2017
"bgr","eubgr","Bulgaria",13129,110114,-96985,2017
"blr","eublr","Belarus",5600,300351,-294751,2017
"che","euche","Switzerland",737537,6595815,-5858278,2017
"cze","eucze","Czechia",349872,3712624,-3362752,2017
"deu","eudeu","Germany",16711789,37593967,-20882178,2017
"dnk","eudnk","Denmark",7951,171184,-163233,2017
"esp","euesp","Spain",1587714,12608138,-11020424,2017
"est","euest","Estonia",27226131,12522307,14703824,2017
"fin","eufin","Finland",3231392,1373561,1857831,2017
"fra","eufra","France",70519187,30389858,40129329,2017
"gbr","eugbr","United Kingdom",25004023,25593461,-589438,2017
"grc","eugrc","Greece",69,30476,-30407,2017
"hrv","euhrv","Croatia",285,4003,-3718,2017
"hun","euhun","Hungary",25433,1610512,-1585079,2017
"irl","euirl","Ireland",37991,24370099,-24332108,2017
"ita","euita","Italy",24661347,12943216,11718131,2017
"ltu","eultu","Lithuania",55233,61423,-6190,2017
"lux","eulux","Luxembourg",103418,74174,29244,2017
"lva","eulva","Latvia",37,10918,-10881,2017
"mkd","eumkd","North Macedonia",48186,7151302,-7103116,2017
"mlt","eumlt","Malta",10,914,-904,2017
"nld","eunld","Netherlands",3554089,30804876,-27250787,2017
"nor","eunor","Norway",27187380,1271549,25915831,2017
"pol","eupol","Poland",2020252,12296385,-10276133,2017
"prt","euprt","Portugal",2966,494214,-491248,2017
"rou","eurou","Romania",4874,102622,-97748,2017
"rus","eurus","Russia",16603816,20577519,-3973703,2017
"srb","eusrb","Serbia",11023,47145,-36122,2017
"svk","eusvk","Slovakia",67,326624,-326557,2017
"svn","eusvn","Slovenia",457657,843651,-385994,2017
"swe","euswe","Sweden",32769,754110,-721341,2017
"ukr","euukr","Ukraine",157062,208373,-51311,2017
"can","nacan","Canada",2071218,3864339,-1793121,2017
"cri","nacri","Costa Rica",2283,28146,-25863,2017
"dom","nadom","Dominican Republic",29,14613,-14584,2017
"gtm","nagtm","Guatemala",23193,9693,13500,2017
"hnd","nahnd","Honduras",23400,1655,21745,2017
"mex","namex","Mexico",730874,4717822,-3986948,2017
"pan","napan","Panama",156,4833,-4677,2017
"slv","naslv","El Salvador",183,208101,-207918,2017
"tto","natto","Trinidad and Tobago",156936,5046,151890,2017
"usa","nausa","United States",24822666,120286200,-95463534,2017
"aus","ocaus","Australia",85179,832637,-747458,2017
"nzl","ocnzl","New Zealand",6980,98326,-91346,2017
"bra","sabra","Brazil",53387,2776340,-2722953,2017
"chl","sachl","Chile",29116,96771,-67655,2017
"col","sacol","Colombia",142,116954,-116812,2017
"ecu","saecu","Ecuador",104,20193,-20089,2017
"per","saper","Peru",1010,245980,-244970,2017
"egy","afegy","Egypt",23129,322144,-299015,2018
"mar","afmar","Morocco",129,27266,-27137,2018
"swz","afswz","Eswatini",3,32,-29,2018
"tza","aftza","Tanzania",71,542,-471,2018
"zaf","afzaf","South Africa",2901729,4614441,-1712712,2018
"are","asare","United Arab Emirates",18323619,697811,17625808,2018
"arm","asarm","Armenia",71,6652,-6581,2018
"chn","aschn","China",362998215,245394923,117603292,2018
"cyp","ascyp","Cyprus",883,32552,-31669,2018
"hkg","ashkg","Hong Kong",5114498,12534897,-7420399,2018
"idn","asidn","Indonesia",36,1035598,-1035562,2018
"ind","asind","India",23874291,10134476,13739815,2018
"irn","asirn","Iran",81166,7699984,-7618818,2018
"isr","asisr","Israel",9027,288309,-279282,2018
"jpn","asjpn","Japan",234551140,260947049,-26395909,2018
"kaz","askaz","Kazakhstan",266610,261878,4732,2018
"kor","askor","South Korea",14703890,73101820,-58397930,2018
"lka","aslka","Sri Lanka",93086,2932,90154,2018
"mmr","asmmr","Burma",63930153,72549,63857604,2018
"mys","asmys","Malaysia",253382454,5714640,247667814,2018
"omn","asomn","Oman",203,63443,-63240,2018
"pak","aspak","Pakistan",79447,469582,-390135,2018
"phl","asphl","Philippines",5797470,20064211,-14266741,2018
"sgp","assgp","Singapore",1460243,23290960,-21830717,2018
"tha","astha","Thailand",1999934,47200325,-45200391,2018
"tur","astur","Turkey",92516,2936117,-2843601,2018
"twn","astwn","Chinese Taipei",4359579,44971599,-40612020,2018
"vnm","asvnm","Vietnam",3706783,150984752,-147277969,2018
"aut","euaut","Austria",18542644,2862447,15680197,2018
"bel","eubel","Belgium",985982,816167,169815,2018
"bgr","eubgr","Bulgaria",20144,117044,-96900,2018
"blr","eublr","Belarus",10200,265751,-255551,2018
"che","euche","Switzerland",1694630,7421695,-5727065,2018
"cze","eucze","Czechia",418106,4217793,-3799687,2018
"deu","eudeu","Germany",14267015,31063333,-16796318,2018
"dnk","eudnk","Denmark",29583,175290,-145707,2018
"esp","euesp","Spain",587281,11742818,-11155537,2018
"est","euest","Estonia",28324285,24849084,3475201,2018
"fin","eufin","Finland",11219853,1829734,9390119,2018
"fra","eufra","France",68029651,25696693,42332958,2018
"gbr","eugbr","United Kingdom",19884474,23163223,-3278749,2018
"grc","eugrc","Greece",351,57916,-57565,2018
"hrv","euhrv","Croatia",1126,4814,-3688,2018
"hun","euhun","Hungary",8515,2127569,-2119054,2018
"irl","euirl","Ireland",49020,22357541,-22308521,2018
"ita","euita","Italy",13332009,6474116,6857893,2018
"ltu","eultu","Lithuania",103830,45111,58719,2018
"lux","eulux","Luxembourg",41973,105089,-63116,2018
"lva","eulva","Latvia",9756,124204,-114448,2018
"mkd","eumkd","North Macedonia",112139,9003720,-8891581,2018
"mlt","eumlt","Malta",8,6298,-6290,2018
"nld","eunld","Netherlands",4822850,31513993,-26691143,2018
"nor","eunor","Norway",22389963,8644710,13745253,2018
"pol","eupol","Poland",1092143,14876382,-13784239,2018
"prt","euprt","Portugal",2683,346619,-343936,2018
"rou","eurou","Romania",76,97486,-97410,2018
"rus","eurus","Russia",27338143,27353065,-14922,2018
"srb","eusrb","Serbia",1923,96422,-94499,2018
"svk","eusvk","Slovakia",200,373605,-373405,2018
"svn","eusvn","Slovenia",280282,334764,-54482,2018
"swe","euswe","Sweden",56287,951997,-895710,2018
"ukr","euukr","Ukraine",115256,182621,-67365,2018
"can","nacan","Canada",1831201,2195211,-364010,2018
"gtm","nagtm","Guatemala",23544,11668,11876,2018
"hnd","nahnd","Honduras",8200,2957,5243,2018
"mex","namex","Mexico",85892,7379175,-7293283,2018
"pan","napan","Panama",4466,78480,-74014,2018
"slv","naslv","El Salvador",60,200111,-200051,2018
"tto","natto","Trinidad and Tobago",43,57,-14,2018
"usa","nausa","United States",104100558,147505469,-43404911,2018
"aus","ocaus","Australia",449983,708332,-258349,2018
"fji","ocfji","Fiji",2873,4232,-1359,2018
"nzl","ocnzl","New Zealand",10156,77585,-67429,2018
"arg","saarg","Argentina",5574,268642,-263068,2018
"bra","sabra","Brazil",16261,5944769,-5928508,2018
"chl","sachl","Chile",294,92894,-92600,2018
"col","sacol","Colombia",1636,108011,-106375,2018
"ecu","saecu","Ecuador",211,11266,-11055,2018
"per","saper","Peru",1086,225577,-224491,2018
"cmr","afcmr","Cameroon",418,275,143,2019
"egy","afegy","Egypt",64,134979,-134915,2019
"ken","afken","Kenya",1834,5174,-3340,2019
"sen","afsen","Senegal",153,534,-381,2019
"zaf","afzaf","South Africa",3178731,4484221,-1305490,2019
"are","asare","United Arab Emirates",16047916,541561,15506355,2019
"brn","asbrn","Brunei",28,202,-174,2019
"chn","aschn","China",336229037,327422175,8806862,2019
"hkg","ashkg","Hong Kong",2469048,20227429,-17758381,2019
"ind","asind","India",37085974,10499390,26586584,2019
"isr","asisr","Israel",6102,377541,-371439,2019
"jpn","asjpn","Japan",206193199,252201950,-46008751,2019
"kaz","askaz","Kazakhstan",114934,1093986,-979052,2019
"kor","askor","South Korea",17989058,66300496,-48311438,2019
"lka","aslka","Sri Lanka",159964,30565,129399,2019
"mmr","asmmr","Burma",152783529,130400,152653129,2019
"mys","asmys","Malaysia",221720470,10269277,211451193,2019
"phl","asphl","Philippines",5391628,24612613,-19220985,2019
"sau","assau","Saudi Arabia",1579,64060,-62481,2019
"sgp","assgp","Singapore",959593,18154138,-17194545,2019
"tha","astha","Thailand",6508471,51891900,-45383429,2019
"tkm","astkm","Turkmenistan",1266228,1444,1264784,2019
"tur","astur","Turkey",6497930,11564778,-5066848,2019
"twn","astwn","Chinese Taipei",22374339,33512371,-11138032,2019
"vnm","asvnm","Vietnam",12723827,148238810,-135514983,2019
"aut","euaut","Austria",17174437,3082027,14092410,2019
"bel","eubel","Belgium",769385,699042,70343,2019
"bgr","eubgr","Bulgaria",12719,105972,-93253,2019
"blr","eublr","Belarus",24200,227141,-202941,2019
"che","euche","Switzerland",831859,5695529,-4863670,2019
"cze","eucze","Czechia",523894,3217803,-2693909,2019
"deu","eudeu","Germany",10995582,22338025,-11342443,2019
"dnk","eudnk","Denmark",49665,396817,-347152,2019
"esp","euesp","Spain",469301,13362304,-12893003,2019
"est","euest","Estonia",23752625,23761744,-9119,2019
"fin","eufin","Finland",20301067,2852270,17448797,2019
"fra","eufra","France",58599255,14478081,44121174,2019
"gbr","eugbr","United Kingdom",7967419,11593355,-3625936,2019
"grc","eugrc","Greece",3302,80902,-77600,2019
"hrv","euhrv","Croatia",253,4818,-4565,2019
"hun","euhun","Hungary",29,1069348,-1069319,2019
"irl","euirl","Ireland",19067,25489765,-25470698,2019
"ita","euita","Italy",21103220,9877412,11225808,2019
"ltu","eultu","Lithuania",258732,246681,12051,2019
"lux","eulux","Luxembourg",44277,21287,22990,2019
"lva","eulva","Latvia",2993,20584,-17591,2019
"mkd","eumkd","North Macedonia",821444,9116703,-8295259,2019
"mlt","eumlt","Malta",9,9191,-9182,2019
"nld","eunld","Netherlands",3233659,16993088,-13759429,2019
"nor","eunor","Norway",26886997,3425446,23461551,2019
"pol","eupol","Poland",1910209,5557878,-3647669,2019
"prt","euprt","Portugal",8939,504044,-495105,2019
"rou","eurou","Romania",13,87006,-86993,2019
"rus","eurus","Russia",26007596,25056305,951291,2019
"srb","eusrb","Serbia",1930,73784,-71854,2019
"svk","eusvk","Slovakia",782,385551,-384769,2019
"svn","eusvn","Slovenia",53392,397818,-344426,2019
"swe","euswe","Sweden",255890,1368359,-1112469,2019
"ukr","euukr","Ukraine",63555,536129,-472574,2019
"can","nacan","Canada",1257889,2266712,-1008823,2019
"gtm","nagtm","Guatemala",24546,16848,7698,2019
"hnd","nahnd","Honduras",156,9062,-8906,2019
"mex","namex","Mexico",7688,4840731,-4833043,2019
"pan","napan","Panama",72,3448,-3376,2019
"slv","naslv","El Salvador",78,145215,-145137,2019
"tto","natto","Trinidad and Tobago",2052,98,1954,2019
"usa","nausa","United States",81813441,141322722,-59509281,2019
"aus","ocaus","Australia",106717,1076083,-969366,2019
"nzl","ocnzl","New Zealand",1820,38606,-36786,2019
"bra","sabra","Brazil",7115,3663248,-3656133,2019
"chl","sachl","Chile",18547,904982,-886435,2019
"per","saper","Peru",3634,295211,-291577,2019
"ken","afken","Kenya",28149,2356,25793,2020
"zaf","afzaf","South Africa",2246000,2964599,-718599,2020
"are","asare","United Arab Emirates",11976308,271745,11704563,2020
"chn","aschn","China",275280142,600340565,-325060423,2020
"hkg","ashkg","Hong Kong",8829438,4631647,4197791,2020
"idn","asidn","Indonesia",174284,753881,-579597,2020
"ind","asind","India",33262769,10862704,22400065,2020
"isr","asisr","Israel",10204,252298,-242094,2020
"jpn","asjpn","Japan",210194874,264661883,-54467009,2020
"kaz","askaz","Kazakhstan",1535213,381111,1154102,2020
"kor","askor","South Korea",17040099,60975969,-43935870,2020
"lka","aslka","Sri Lanka",49593,37779,11814,2020
"mmr","asmmr","Burma",387673406,46719,387626687,2020
"mys","asmys","Malaysia",240895786,21445153,219450633,2020
"omn","asomn","Oman",2874,245055,-242181,2020
"phl","asphl","Philippines",5307794,23002177,-17694383,2020
"qat","asqat","Qatar",192,673,-481,2020
"sgp","assgp","Singapore",508704,14358164,-13849460,2020
"tha","astha","Thailand",9738814,61317800,-51578986,2020
"tur","astur","Turkey",16501597,19993703,-3492106,2020
"twn","astwn","Chinese Taipei",6043496,48167078,-42123582,2020
"vnm","asvnm","Vietnam",22181280,125431073,-103249793,2020
"aut","euaut","Austria",15983842,1906661,14077181,2020
"bel","eubel","Belgium",1816085,508861,1307224,2020
"bgr","eubgr","Bulgaria",103,120076,-119973,2020
"blr","eublr","Belarus",500,110845,-110345,2020
"che","euche","Switzerland",4710605,7142770,-2432165,2020
"cze","eucze","Czechia",612135,1735147,-1123012,2020
"deu","eudeu","Germany",14107445,22134735,-8027290,2020
"dnk","eudnk","Denmark",89333,399072,-309739,2020
"esp","euesp","Spain",401345,12505016,-12103671,2020
"est","euest","Estonia",20247119,21856588,-1609469,2020
"fin","eufin","Finland",18855058,1678500,17176558,2020
"fra","eufra","France",56880980,17858100,39022880,2020
"gbr","eugbr","United Kingdom",6089848,11869222,-5779374,2020
"grc","eugrc","Greece",301,139074,-138773,2020
"hrv","euhrv","Croatia",190,8285,-8095,2020
"hun","euhun","Hungary",2000,1007051,-1005051,2020
"irl","euirl","Ireland",9088,18308572,-18299484,2020
"isl","euisl","Iceland",8349,77731,-69382,2020
"ita","euita","Italy",12785317,8133314,4652003,2020
"ltu","eultu","Lithuania",90058,53847,36211,2020
"lux","eulux","Luxembourg",226500,4514,221986,2020
"lva","eulva","Latvia",127941,145766,-17825,2020
"mkd","eumkd","North Macedonia",57506,7150290,-7092784,2020
"mlt","eumlt","Malta",2194,12943,-10749,2020
"nld","eunld","Netherlands",1908561,11925077,-10016516,2020
"nor","eunor","Norway",19575358,3168149,16407209,2020
"pol","eupol","Poland",2719666,9110860,-6391194,2020
"prt","euprt","Portugal",7355,439552,-432197,2020
"rou","eurou","Romania",45,85532,-85487,2020
"rus","eurus","Russia",26053918,24305373,1748545,2020
"srb","eusrb","Serbia",2118,131918,-129800,2020
"svk","eusvk","Slovakia",10871,463053,-452182,2020
"svn","eusvn","Slovenia",522707,241084,281623,2020
"swe","euswe","Sweden",153800,1190839,-1037039,2020
"ukr","euukr","Ukraine",59364,504794,-445430,2020
"can","nacan","Canada",848836,1976266,-1127430,2020
"cri","nacri","Costa Rica",296,13695,-13399,2020
"gtm","nagtm","Guatemala",15757,9763,5994,2020
"mex","namex","Mexico",6522,4579792,-4573270,2020
"slv","naslv","El Salvador",276,154268,-153992,2020
"usa","nausa","United States",115799898,96940869,18859029,2020
"aus","ocaus","Australia",2273126,617298,1655828,2020
"nzl","ocnzl","New Zealand",273,22862,-22589,2020
"bra","sabra","Brazil",37442,2353301,-2315859,2020
"chl","sachl","Chile",347,100818,-100471,2020
"col","sacol","Colombia",18205,62181,-43976,2020
"per","saper","Peru",662,134346,-133684,2020
"bdi","afbdi","Burundi",10,3,7,2021
"bwa","afbwa","Botswana",12844,2076,10768,2021
"cod","afcod","Democratic Republic of the Congo",63,1339,-1276,2021
"ken","afken","Kenya",20424,7092,13332,2021
"nam","afnam","Namibia",5958,1294,4664,2021
"nga","afnga","Nigeria",1383,67094,-65711,2021
"uga","afuga","Uganda",3,14360,-14357,2021
"zaf","afzaf","South Africa",4644170,4215800,428370,2021
"are","asare","United Arab Emirates",11361717,547852,10813865,2021
"chn","aschn","China",512608419,1307197885,-794589466,2021
"hkg","ashkg","Hong Kong",3516923,4805201,-1288278,2021
"idn","asidn","Indonesia",1679074,840888,838186,2021
"ind","asind","India",56769576,11699794,45069782,2021
"isr","asisr","Israel",33219,170542,-137323,2021
"jpn","asjpn","Japan",200616486,317736312,-117119826,2021
"kaz","askaz","Kazakhstan",4901884,210053,4691831,2021
"kor","askor","South Korea",27333966,84141329,-56807363,2021
"lka","aslka","Sri Lanka",114959,20236,94723,2021
"mmr","asmmr","Burma",811631627,52206,811579421,2021
"mys","asmys","Malaysia",424182488,5920153,418262335,2021
"phl","asphl","Philippines",5899498,28877141,-22977643,2021
"sau","assau","Saudi Arabia",55,68532,-68477,2021
"sgp","assgp","Singapore",996842,6133058,-5136216,2021
"tha","astha","Thailand",3318166,100869157,-97550991,2021
"tur","astur","Turkey",1130019,40939293,-39809274,2021
"twn","astwn","Chinese Taipei",5930049,70073698,-64143649,2021
"vnm","asvnm","Vietnam",37756316,291367851,-253611535,2021
"aut","euaut","Austria",15728836,3432473,12296363,2021
"bel","eubel","Belgium",1636014,1605961,30053,2021
"bgr","eubgr","Bulgaria",1263,271789,-270526,2021
"blr","eublr","Belarus",32900,262792,-229892,2021
"che","euche","Switzerland",1555902,8550117,-6994215,2021
"cze","eucze","Czechia",696632,3637417,-2940785,2021
"deu","eudeu","Germany",25980846,45903490,-19922644,2021
"dnk","eudnk","Denmark",46301,561655,-515354,2021
"esp","euesp","Spain",1260408,17275572,-16015164,2021
"est","euest","Estonia",39175933,31584048,7591885,2021
"fin","eufin","Finland",36442435,1032495,35409940,2021
"fra","eufra","France",69724325,34729636,34994689,2021
"gbr","eugbr","United Kingdom",6762429,12818447,-6056018,2021
"grc","eugrc","Greece",705,36961,-36256,2021
"hrv","euhrv","Croatia",196,237351,-237155,2021
"hun","euhun","Hungary",51983,1604634,-1552651,2021
"irl","euirl","Ireland",17950,29982586,-29964636,2021
"ita","euita","Italy",12220040,9318272,2901768,2021
"ltu","eultu","Lithuania",136154,118329,17825,2021
"lux","eulux","Luxembourg",755513,288908,466605,2021
"lva","eulva","Latvia",548,51411,-50863,2021
"mkd","eumkd","North Macedonia",237355,11337317,-11099962,2021
"mlt","eumlt","Malta",1,4630,-4629,2021
"nld","eunld","Netherlands",19388357,17095819,2292538,2021
"nor","eunor","Norway",29812423,3567521,26244902,2021
"pol","eupol","Poland",3645968,20432957,-16786989,2021
"prt","euprt","Portugal",13154,509513,-496359,2021
"rou","eurou","Romania",9,148470,-148461,2021
"rus","eurus","Russia",38473667,39083999,-610332,2021
"srb","eusrb","Serbia",6849,61624,-54775,2021
"svk","eusvk","Slovakia",851,853138,-852287,2021
"svn","eusvn","Slovenia",179837,327666,-147829,2021
"swe","euswe","Sweden",29750,1256736,-1226986,2021
"ukr","euukr","Ukraine",77027,315926,-238899,2021
"can","nacan","Canada",1504301,4208187,-2703886,2021
"dom","nadom","Dominican Republic",40132,5046,35086,2021
"gtm","nagtm","Guatemala",22753,13715,9038,2021
"mex","namex","Mexico",2446,3081360,-3078914,2021
"pan","napan","Panama",766,37715,-36949,2021
"tto","natto","Trinidad and Tobago",1,3324,-3323,2021
"usa","nausa","United States",301276153,133192467,168083686,2021
"aus","ocaus","Australia",1920712,748582,1172130,2021
"nzl","ocnzl","New Zealand",1750,38245,-36495,2021
"arg","saarg","Argentina",174,127980,-127806,2021
"bra","sabra","Brazil",76920,2131246,-2054326,2021
"chl","sachl","Chile",109,126290,-126181,2021
"col","sacol","Colombia",31967,112474,-80507,2021
"per","saper","Peru",13879,493100,-479221,2021
"ury","saury","Uruguay",47,10159,-10112,2021
"eth","afeth","Ethiopia",11,2337,-2326,2022
"ken","afken","Kenya",38754,22485,16269,2022
"tun","aftun","Tunisia",17,9859,-9842,2022
"zaf","afzaf","South Africa",5242056,7457797,-2215741,2022
"zmb","afzmb","Zambia",493,1352,-859,2022
"are","asare","United Arab Emirates",10189397,573636,9615761,2022
"arm","asarm","Armenia",24631,20953,3678,2022
"chn","aschn","China",679479705,1481143953,-801664248,2022
"cyp","ascyp","Cyprus",1,29369,-29368,2022
"hkg","ashkg","Hong Kong",1164403,3724163,-2559760,2022
"idn","asidn","Indonesia",2327,769932,-767605,2022
"ind","asind","India",71499748,8245739,63254009,2022
"irn","asirn","Iran",72,204409,-204337,2022
"isr","asisr","Israel",1690527,451418,1239109,2022
"jpn","asjpn","Japan",250564532,488049709,-237485177,2022
"kaz","askaz","Kazakhstan",6455132,212377,6242755,2022
"kor","askor","South Korea",21831815,92421912,-70590097,2022
"mmr","asmmr","Burma",604299319,54580,604244739,2022
"mng","asmng","Mongolia",3207,27600,-24393,2022
"mys","asmys","Malaysia",690027348,7065835,682961513,2022
"omn","asomn","Oman",913,84017,-83104,2022
"phl","asphl","Philippines",12619075,68809250,-56190175,2022
"qat","asqat","Qatar",718,2596,-1878,2022
"sgp","assgp","Singapore",2118770,3764486,-1645716,2022
"tha","astha","Thailand",7664500,160765289,-153100789,2022
"tur","astur","Turkey",726917,15481152,-14754235,2022
"twn","astwn","Chinese Taipei",9463813,73772431,-64308618,2022
"vnm","asvnm","Vietnam",75543813,376139990,-300596177,2022
"aut","euaut","Austria",19229047,4873348,14355699,2022
"bel","eubel","Belgium",842986,3035799,-2192813,2022
"bgr","eubgr","Bulgaria",895,1040363,-1039468,2022
"blr","eublr","Belarus",2491,173715,-171224,2022
"che","euche","Switzerland",836150,9260042,-8423892,2022
"cze","eucze","Czechia",1104985,4260309,-3155324,2022
"deu","eudeu","Germany",25435498,59356574,-33921076,2022
"dnk","eudnk","Denmark",19407,465554,-446147,2022
"esp","euesp","Spain",672963,19052425,-18379462,2022
"est","euest","Estonia",52082388,35720218,16362170,2022
"fin","eufin","Finland",841808,1056806,-214998,2022
"fra","eufra","France",92304131,42585096,49719035,2022
"gbr","eugbr","United Kingdom",7016349,9780106,-2763757,2022
"grc","eugrc","Greece",1753,36617,-34864,2022
"hrv","euhrv","Croatia",159,15800,-15641,2022
"hun","euhun","Hungary",27952,3753934,-3725982,2022
"irl","euirl","Ireland",20169,20926957,-20906788,2022
"isl","euisl","Iceland",14,42092,-42078,2022
"ita","euita","Italy",11991207,14118218,-2127011,2022
"ltu","eultu","Lithuania",138399,186880,-48481,2022
"lux","eulux","Luxembourg",1130094,120109,1009985,2022
"lva","eulva","Latvia",57529,25142,32387,2022
"mkd","eumkd","North Macedonia",60817,17066870,-17006053,2022
"nld","eunld","Netherlands",21567716,22427547,-859831,2022
"nor","eunor","Norway",21349137,8426017,12923120,2022
"pol","eupol","Poland",9341029,17598326,-8257297,2022
"prt","euprt","Portugal",29013,846295,-817282,2022
"rou","eurou","Romania",11979,183465,-171486,2022
"rus","eurus","Russia",41656232,30434123,11222109,2022
"srb","eusrb","Serbia",1641,135021,-133380,2022
"svk","eusvk","Slovakia",3253,1038295,-1035042,2022
"svn","eusvn","Slovenia",128369,254169,-125800,2022
"swe","euswe","Sweden",46048,3828925,-3782877,2022
"ukr","euukr","Ukraine",39547,289178,-249631,2022
"can","nacan","Canada",1069689,5847133,-4777444,2022
"cri","nacri","Costa Rica",2,19689,-19687,2022
"dom","nadom","Dominican Republic",4885,22203,-17318,2022
"gtm","nagtm","Guatemala",19451,31417,-11966,2022
"mex","namex","Mexico",6730,5182433,-5175703,2022
"pan","napan","Panama",1311,15259,-13948,2022
"tto","natto","Trinidad and Tobago",277,315,-38.0000000000001,2022
"usa","nausa","United States",577197014,195766061,381430953,2022
"aus","ocaus","Australia",3097678,1242081,1855597,2022
"ncl","ocncl","New Caledonia",1436,101,1335,2022
"nzl","ocnzl","New Zealand",30742,21252,9490,2022
"arg","saarg","Argentina",240849,269565,-28716,2022
"bra","sabra","Brazil",18826,3739322,-3720496,2022
"col","sacol","Colombia",8023,54166,-46143,2022
"per","saper","Peru",1751,520757,-519006,2022
